date,gpu_name,flipkart_price,flipkart_rating,flipkart_reviews,amazon_price,amazon_rating,amazon_reviews,aliexpress_price,aliexpress_rating,aliexpress_reviews,price_diff_amazon,price_diff_aliexpress,average_rating,discount_flag,units_sold,revenue
2025-04-04,NVIDIA RTX 3060,36796,4.6,601,50944,4.5,641,81067,4.1,690,-14148,-44271,4.3999999999999995,1,120,4415520
2025-04-04,NVIDIA RTX 3070,52399,4.6,1485,49915,4.5,1988,79882,3.8,481,2484,-27483,4.3,0,8,419192
2025-04-04,NVIDIA RTX 3080,38232,4.1,161,86323,4.4,570,41229,4.2,1129,-48091,-2997,4.233333333333333,1,271,10360872
2025-04-04,AMD RX 6600,36071,3.8,1332,74729,3.7,133,40140,4.4,535,-38658,-4069,3.966666666666667,1,205,7394555
2025-04-04,AMD RX 6700 XT,30075,3.8,1430,52804,4.8,1132,47977,3.6,474,-22729,-17902,4.066666666666666,1,131,3939825
2025-04-04,NVIDIA RTX 4060,78792,4.2,669,78248,4.4,463,49274,5.0,1885,544,29518,4.533333333333334,0,12,945504
2025-04-04,AMD RX 7900 XTX,24158,4.5,796,89409,4.4,1897,79191,4.4,1378,-65251,-55033,4.433333333333334,1,358,8648564
2025-04-03,NVIDIA RTX 3060,59694,3.8,1663,95778,4.6,290,41525,3.7,700,-36084,18169,4.033333333333332,0,226,13490844
2025-04-03,NVIDIA RTX 3070,66955,3.6,298,90609,3.7,1335,36327,3.7,231,-23654,30628,3.6666666666666665,0,158,10578890
2025-04-03,NVIDIA RTX 3080,71869,4.4,1752,27715,4.5,1169,67089,4.4,1078,44154,4780,4.433333333333334,0,1,71869
2025-04-03,AMD RX 6600,33672,4.2,355,80173,4.8,1528,91106,4.6,119,-46501,-57434,4.533333333333333,1,253,8519016
2025-04-03,AMD RX 6700 XT,72260,4.3,1798,94958,3.8,1743,32181,4.6,114,-22698,40079,4.233333333333333,0,145,10477700
2025-04-03,NVIDIA RTX 4060,74129,3.8,242,88315,4.0,1747,28279,3.8,1721,-14186,45850,3.8666666666666667,0,105,7783545
2025-04-03,AMD RX 7900 XTX,33423,3.8,692,38292,3.7,1077,26028,4.4,1659,-4869,7395,3.966666666666667,0,70,2339610
2025-04-02,NVIDIA RTX 3060,34365,4.8,878,53161,3.9,1895,60823,4.2,790,-18796,-26458,4.3,1,108,3711420
2025-04-02,NVIDIA RTX 3070,62148,4.5,847,77673,3.8,1552,81046,4.1,1923,-15525,-18898,4.133333333333334,1,130,8079240
2025-04-02,NVIDIA RTX 3080,46351,4.0,1472,27666,4.3,1164,69549,4.7,839,18685,-23198,4.333333333333333,0,1,46351
2025-04-02,AMD RX 6600,62742,4.9,1427,26014,4.5,1508,77328,4.4,829,36728,-14586,4.6000000000000005,0,1,62742
2025-04-02,AMD RX 6700 XT,36348,4.5,1193,66754,4.0,416,66107,3.5,1882,-30406,-29759,4.0,1,189,6869772
2025-04-02,NVIDIA RTX 4060,55425,4.2,652,83183,4.4,635,80606,4.8,1994,-27758,-25181,4.466666666666668,1,161,8923425
2025-04-02,AMD RX 7900 XTX,56393,4.0,1673,82142,4.0,664,40411,4.4,1879,-25749,15982,4.133333333333334,0,159,8966487
2025-04-01,NVIDIA RTX 3060,31207,4.7,1748,75763,4.1,1705,93839,4.9,1638,-44556,-62632,4.566666666666667,1,274,8550718
2025-04-01,NVIDIA RTX 3070,66633,3.9,532,86702,4.1,1236,57594,4.2,1505,-20069,9039,4.066666666666666,0,113,7529529
2025-04-01,NVIDIA RTX 3080,64986,4.5,910,87485,5.0,1283,88503,4.1,484,-22499,-23517,4.533333333333333,1,142,9228012
2025-04-01,AMD RX 6600,83312,3.9,605,72914,4.1,382,27637,4.9,1764,10398,55675,4.3,0,1,83312
2025-04-01,AMD RX 6700 XT,61226,4.1,1295,39490,4.2,1532,64365,4.5,1888,21736,-3139,4.266666666666667,0,1,61226
2025-04-01,NVIDIA RTX 4060,77315,3.8,383,44027,3.8,920,30663,4.5,578,33288,46652,4.033333333333333,0,1,77315
2025-04-01,AMD RX 7900 XTX,92826,3.6,196,70869,4.4,1501,88787,4.6,1726,21957,4039,4.2,0,1,92826
2025-03-31,NVIDIA RTX 3060,37623,4.4,1722,30138,4.1,1402,35518,4.1,1075,7485,2105,4.2,0,6,225738
2025-03-31,NVIDIA RTX 3070,82218,3.6,881,23439,4.7,1065,38318,3.9,499,58779,43900,4.066666666666667,0,1,82218
2025-03-31,NVIDIA RTX 3080,87682,3.9,1233,79787,3.6,554,45024,4.8,1707,7895,42658,4.1000000000000005,0,1,87682
2025-03-31,AMD RX 6600,29076,4.6,1496,71261,4.4,1583,88403,3.7,1731,-42185,-59327,4.233333333333333,1,254,7385304
2025-03-31,AMD RX 6700 XT,62223,4.0,701,75656,4.4,1167,35883,4.7,1223,-13433,26340,4.366666666666667,0,82,5102286
2025-03-31,NVIDIA RTX 4060,80280,4.2,1578,65377,4.9,217,84560,4.8,336,14903,-4280,4.633333333333334,0,1,80280
2025-03-31,AMD RX 7900 XTX,60622,4.6,1139,50218,4.2,121,90626,4.3,598,10404,-30004,4.366666666666667,0,1,60622
2025-03-30,NVIDIA RTX 3060,41069,3.9,1408,53819,4.9,1161,51136,4.6,1451,-12750,-10067,4.466666666666667,1,83,3408727
2025-03-30,NVIDIA RTX 3070,93528,3.8,865,61082,3.6,1327,34586,4.2,1565,32446,58942,3.866666666666667,0,1,93528
2025-03-30,NVIDIA RTX 3080,47592,4.9,1989,93143,4.5,1359,27142,4.9,768,-45551,20450,4.766666666666667,0,274,13040208
2025-03-30,AMD RX 6600,91518,4.4,1100,49735,3.6,589,74560,3.8,627,41783,16958,3.9333333333333336,0,1,91518
2025-03-30,AMD RX 6700 XT,25468,4.9,1899,23326,3.6,665,89922,3.7,378,2142,-64454,4.066666666666666,0,17,432956
2025-03-30,NVIDIA RTX 4060,64267,3.6,1898,77246,4.5,930,87222,4.7,781,-12979,-22955,4.266666666666667,1,80,5141360
2025-03-30,AMD RX 7900 XTX,33023,4.6,1771,52496,3.5,1541,56052,4.6,1330,-19473,-23029,4.233333333333333,1,133,4392059
2025-03-29,NVIDIA RTX 3060,35434,4.6,362,31731,4.3,1587,35751,4.0,1964,3703,-317,4.3,0,16,566944
2025-03-29,NVIDIA RTX 3070,88799,3.7,1180,70471,4.9,666,77379,4.5,1250,18328,11420,4.366666666666667,0,1,88799
2025-03-29,NVIDIA RTX 3080,79196,4.9,1646,56628,4.9,1031,81184,3.8,336,22568,-1988,4.533333333333334,0,1,79196
2025-03-29,AMD RX 6600,54205,4.0,1475,79656,3.5,458,60856,3.7,796,-25451,-6651,3.733333333333333,1,164,8889620
2025-03-29,AMD RX 6700 XT,74532,4.8,1024,79510,3.7,248,47613,4.4,360,-4978,26919,4.3,0,59,4397388
2025-03-29,NVIDIA RTX 4060,39890,3.8,792,90361,4.0,339,66188,4.4,103,-50471,-26298,4.066666666666666,1,267,10650630
2025-03-29,AMD RX 7900 XTX,29576,4.3,1305,91388,4.8,1765,63243,4.4,488,-61812,-33667,4.5,1,352,10410752
2025-03-28,NVIDIA RTX 3060,50922,3.6,1392,60472,4.2,872,76345,4.0,847,-9550,-25423,3.9333333333333336,1,83,4226526
2025-03-28,NVIDIA RTX 3070,31591,3.6,164,87382,4.6,1688,42812,4.5,1309,-55791,-11221,4.233333333333333,1,323,10203893
2025-03-28,NVIDIA RTX 3080,65889,4.3,670,87725,4.2,1301,51989,4.1,1202,-21836,13900,4.2,0,124,8170236
2025-03-28,AMD RX 6600,87379,4.3,1581,29532,3.7,238,84960,3.7,707,57847,2419,3.9,0,1,87379
2025-03-28,AMD RX 6700 XT,85943,4.7,1753,77347,4.7,551,54786,4.5,401,8596,31157,4.633333333333334,0,1,85943
2025-03-28,NVIDIA RTX 4060,76913,3.6,1449,54723,4.1,823,60338,4.6,1839,22190,16575,4.1,0,1,76913
2025-03-28,AMD RX 7900 XTX,81400,4.1,1056,94087,3.5,1804,31407,4.0,1128,-12687,49993,3.8666666666666667,0,83,6756200
2025-03-27,NVIDIA RTX 3060,34616,4.5,1423,58550,3.9,917,40422,5.0,1546,-23934,-5806,4.466666666666667,1,167,5780872
2025-03-27,NVIDIA RTX 3070,35395,4.1,794,67447,4.3,465,89858,4.7,1113,-32052,-54463,4.366666666666666,1,176,6229520
2025-03-27,NVIDIA RTX 3080,38358,3.8,1198,87034,4.0,1931,65974,4.9,220,-48676,-27616,4.233333333333333,1,267,10241586
2025-03-27,AMD RX 6600,81948,4.1,670,58765,4.9,1499,66915,4.7,531,23183,15033,4.566666666666666,0,1,81948
2025-03-27,AMD RX 6700 XT,84683,4.8,254,51012,4.6,580,57237,4.6,1990,33671,27446,4.666666666666666,0,1,84683
2025-03-27,NVIDIA RTX 4060,84590,3.6,1435,55900,3.8,515,49457,4.6,712,28690,35133,4.0,0,1,84590
2025-03-27,AMD RX 7900 XTX,24698,4.9,1838,59795,4.0,1695,43041,4.3,791,-35097,-18343,4.3999999999999995,1,204,5038392
2025-03-26,NVIDIA RTX 3060,54344,4.1,1085,36965,4.9,1484,82922,4.2,813,17379,-28578,4.3999999999999995,0,1,54344
2025-03-26,NVIDIA RTX 3070,53301,4.9,437,91602,3.5,1855,76499,3.6,1588,-38301,-23198,4.0,1,220,11726220
2025-03-26,NVIDIA RTX 3080,71689,5.0,643,31489,4.1,745,61411,4.5,499,40200,10278,4.533333333333333,0,1,71689
2025-03-26,AMD RX 6600,83974,4.1,1596,91238,4.8,1105,74409,3.7,1640,-7264,9565,4.199999999999999,0,82,6885868
2025-03-26,AMD RX 6700 XT,87056,3.8,545,50156,3.9,554,34906,4.0,1440,36900,52150,3.9,0,1,87056
2025-03-26,NVIDIA RTX 4060,34409,4.6,224,39252,4.3,966,48183,3.7,1525,-4843,-13774,4.199999999999999,1,39,1341951
2025-03-26,AMD RX 7900 XTX,63572,3.6,1076,89123,3.5,811,87618,4.8,529,-25551,-24046,3.9666666666666663,1,152,9662944
2025-03-25,NVIDIA RTX 3060,92259,3.7,1140,79227,4.7,1036,52193,4.6,118,13032,40066,4.333333333333333,0,1,92259
2025-03-25,NVIDIA RTX 3070,34022,3.6,239,43496,4.3,746,75424,4.8,308,-9474,-41402,4.233333333333333,1,59,2007298
2025-03-25,NVIDIA RTX 3080,56135,3.7,1923,23199,4.5,877,44430,4.9,974,32936,11705,4.366666666666666,0,1,56135
2025-03-25,AMD RX 6600,59013,4.4,1368,37870,4.0,1865,44510,3.6,1070,21143,14503,4.0,0,1,59013
2025-03-25,AMD RX 6700 XT,36179,4.5,1257,57572,4.3,585,45973,3.7,1155,-21393,-9794,4.166666666666667,1,133,4811807
2025-03-25,NVIDIA RTX 4060,93113,4.9,518,61172,4.9,802,71227,4.2,404,31941,21886,4.666666666666667,0,1,93113
2025-03-25,AMD RX 7900 XTX,65135,3.9,368,71468,4.2,531,76959,3.6,593,-6333,-11824,3.9,1,50,3256750
2025-03-24,NVIDIA RTX 3060,65066,4.0,1639,82671,4.6,847,77991,4.0,1320,-17605,-12925,4.2,1,131,8523646
2025-03-24,NVIDIA RTX 3070,31584,4.2,1253,76796,4.2,1270,49955,4.6,1688,-45212,-18371,4.333333333333333,1,257,8117088
2025-03-24,NVIDIA RTX 3080,35704,4.3,1136,43905,4.5,1767,37543,4.8,1431,-8201,-1839,4.533333333333334,1,73,2606392
2025-03-24,AMD RX 6600,57845,4.9,1904,40994,3.9,582,74336,4.4,1011,16851,-16491,4.4,0,1,57845
2025-03-24,AMD RX 6700 XT,33017,4.1,423,81771,3.8,1738,70240,3.7,269,-48754,-37223,3.8666666666666667,1,295,9740015
2025-03-24,NVIDIA RTX 4060,83883,4.6,1352,45475,4.7,461,42004,4.5,1960,38408,41879,4.6000000000000005,0,1,83883
2025-03-24,AMD RX 7900 XTX,91393,4.5,1235,81341,3.7,1929,90655,3.5,1273,10052,738,3.9,0,1,91393
2025-03-23,NVIDIA RTX 3060,66674,3.7,1898,94139,4.6,1708,87090,4.5,293,-27465,-20416,4.266666666666667,1,179,11934646
2025-03-23,NVIDIA RTX 3070,41767,3.7,319,88239,3.9,1858,48881,4.2,1420,-46472,-7114,3.9333333333333336,1,260,10859420
2025-03-23,NVIDIA RTX 3080,44605,3.9,531,31516,3.6,434,81284,4.4,303,13089,-36679,3.966666666666667,0,1,44605
2025-03-23,AMD RX 6600,68609,4.5,1846,31634,4.7,1075,65148,4.6,1865,36975,3461,4.6,0,1,68609
2025-03-23,AMD RX 6700 XT,60740,4.2,1954,38307,4.6,632,49553,4.7,140,22433,11187,4.5,0,1,60740
2025-03-23,NVIDIA RTX 4060,29414,4.5,1798,72263,4.3,1758,78170,4.7,1704,-42849,-48756,4.5,1,261,7677054
2025-03-23,AMD RX 7900 XTX,58626,3.5,1679,58598,3.5,348,95481,3.6,1814,28,-36855,3.533333333333333,0,13,762138
2025-03-22,NVIDIA RTX 3060,44365,5.0,430,73585,4.9,507,39963,4.9,1938,-29220,4402,4.933333333333334,0,161,7142765
2025-03-22,NVIDIA RTX 3070,84431,4.6,1248,47208,4.0,1478,38858,4.8,1523,37223,45573,4.466666666666666,0,1,84431
2025-03-22,NVIDIA RTX 3080,24183,3.6,1908,92897,4.7,1015,45627,4.3,1739,-68714,-21444,4.2,1,390,9431370
2025-03-22,AMD RX 6600,46005,3.6,856,35398,4.4,1049,64202,3.6,1277,10607,-18197,3.8666666666666667,0,1,46005
2025-03-22,AMD RX 6700 XT,44930,3.7,731,42357,4.5,790,54376,3.7,1251,2573,-9446,3.9666666666666663,0,10,449300
2025-03-22,NVIDIA RTX 4060,70121,4.8,530,82459,4.4,928,55940,3.6,355,-12338,14181,4.266666666666667,0,88,6170648
2025-03-22,AMD RX 7900 XTX,60169,3.7,1697,31999,3.7,567,90786,4.0,1214,28170,-30617,3.8000000000000003,0,1,60169
2025-03-21,NVIDIA RTX 3060,80348,4.6,1995,65683,4.5,1554,47957,5.0,1447,14665,32391,4.7,0,1,80348
2025-03-21,NVIDIA RTX 3070,54360,5.0,1760,62017,4.5,655,24045,4.0,1163,-7657,30315,4.5,0,52,2826720
2025-03-21,NVIDIA RTX 3080,48583,3.5,1608,83288,4.6,1166,65855,4.3,386,-34705,-17272,4.133333333333333,1,205,9959515
2025-03-21,AMD RX 6600,68912,4.7,1869,84411,3.8,1849,91977,4.0,1965,-15499,-23065,4.166666666666667,1,95,6546640
2025-03-21,AMD RX 6700 XT,56712,3.7,1536,26051,4.6,1455,73117,4.3,529,30661,-16405,4.2,0,1,56712
2025-03-21,NVIDIA RTX 4060,39301,4.8,1858,60723,4.6,531,40405,4.7,585,-21422,-1104,4.699999999999999,1,143,5620043
2025-03-21,AMD RX 7900 XTX,85516,3.8,1980,47129,3.7,230,28354,3.7,1853,38387,57162,3.733333333333333,0,1,85516
2025-03-20,NVIDIA RTX 3060,85196,4.0,1728,88513,3.6,1678,51307,4.4,542,-3317,33889,4.0,0,37,3152252
2025-03-20,NVIDIA RTX 3070,53657,3.5,495,78329,4.6,270,71335,3.7,1374,-24672,-17678,3.9333333333333336,1,158,8477806
2025-03-20,NVIDIA RTX 3080,76916,3.9,242,37772,4.4,272,77923,4.3,633,39144,-1007,4.2,0,1,76916
2025-03-20,AMD RX 6600,61461,4.5,918,75631,3.8,1610,77362,4.9,919,-14170,-15901,4.4,1,92,5654412
2025-03-20,AMD RX 6700 XT,65630,3.7,634,62877,4.4,368,82459,4.9,1485,2753,-16829,4.333333333333334,0,30,1968900
2025-03-20,NVIDIA RTX 4060,50161,4.9,643,92438,3.5,1458,83439,3.7,517,-42277,-33278,4.033333333333334,1,224,11236064
2025-03-20,AMD RX 7900 XTX,27902,4.4,807,71435,4.8,1056,36405,4.6,1396,-43533,-8503,4.6,1,269,7505638
2025-03-19,NVIDIA RTX 3060,66688,4.4,1147,62198,4.2,1528,53100,4.1,1446,4490,13588,4.233333333333333,0,28,1867264
2025-03-19,NVIDIA RTX 3070,40312,4.8,489,50044,4.4,1392,93988,3.7,1782,-9732,-53676,4.3,1,79,3184648
2025-03-19,NVIDIA RTX 3080,55749,4.6,103,83301,4.5,1193,44709,5.0,988,-27552,11040,4.7,0,167,9310083
2025-03-19,AMD RX 6600,94556,4.5,1619,65431,4.2,565,71880,4.9,606,29125,22676,4.533333333333333,0,1,94556
2025-03-19,AMD RX 6700 XT,50808,4.1,1460,37357,4.0,944,34373,3.7,325,13451,16435,3.9333333333333336,0,1,50808
2025-03-19,NVIDIA RTX 4060,70383,4.0,1836,57328,4.0,100,75857,4.0,282,13055,-5474,4.0,0,1,70383
2025-03-19,AMD RX 7900 XTX,44230,4.9,1138,91708,4.0,1060,72287,4.7,399,-47478,-28057,4.533333333333334,1,274,12119020
2025-03-18,NVIDIA RTX 3060,68001,4.1,924,28724,4.9,1647,53832,3.5,872,39277,14169,4.166666666666667,0,1,68001
2025-03-18,NVIDIA RTX 3070,65293,3.7,961,86984,3.5,981,54228,4.9,1703,-21691,11065,4.033333333333334,0,130,8488090
2025-03-18,NVIDIA RTX 3080,77243,4.6,456,65283,3.8,114,39626,4.3,1893,11960,37617,4.233333333333333,0,1,77243
2025-03-18,AMD RX 6600,64772,4.3,100,72518,4.1,1248,67003,4.7,1102,-7746,-2231,4.366666666666666,1,66,4274952
2025-03-18,AMD RX 6700 XT,64179,3.8,1709,82525,3.9,1564,38855,4.0,1271,-18346,25324,3.9,0,123,7894017
2025-03-18,NVIDIA RTX 4060,68046,4.2,1483,76180,3.8,262,63479,3.9,302,-8134,4567,3.966666666666667,0,64,4354944
2025-03-18,AMD RX 7900 XTX,54197,4.2,1945,82465,3.9,1665,29684,4.0,1639,-28268,24513,4.033333333333333,0,173,9376081
2025-03-17,NVIDIA RTX 3060,49638,3.6,1155,59965,4.5,1189,74540,4.0,1618,-10327,-24902,4.033333333333333,1,77,3822126
2025-03-17,NVIDIA RTX 3070,66698,4.7,1638,60617,3.8,240,96207,4.4,1840,6081,-29509,4.3,0,7,466886
2025-03-17,NVIDIA RTX 3080,58295,4.0,1751,47027,3.9,1404,78682,4.4,630,11268,-20387,4.1000000000000005,0,1,58295
2025-03-17,AMD RX 6600,49307,3.5,601,86742,4.2,1534,28869,4.3,418,-37435,20438,4.0,0,215,10601005
2025-03-17,AMD RX 6700 XT,89284,4.8,249,88024,4.0,411,39731,4.1,1606,1260,49553,4.3,0,34,3035656
2025-03-17,NVIDIA RTX 4060,85087,4.8,1278,32887,3.5,309,57477,4.9,1409,52200,27610,4.4,0,1,85087
2025-03-17,AMD RX 7900 XTX,53369,4.5,1112,61182,3.7,997,76311,4.7,1488,-7813,-22942,4.3,1,79,4216151
2025-03-16,NVIDIA RTX 3060,76381,3.7,1508,24982,3.6,130,82609,4.2,998,51399,-6228,3.8333333333333335,0,1,76381
2025-03-16,NVIDIA RTX 3070,23599,4.7,548,88473,4.0,738,72238,4.3,664,-64874,-48639,4.333333333333333,1,369,8708031
2025-03-16,NVIDIA RTX 3080,50753,4.3,202,90367,4.2,1720,82332,4.9,1905,-39614,-31579,4.466666666666667,1,235,11926955
2025-03-16,AMD RX 6600,55656,4.2,1741,28864,3.6,1637,54484,4.5,278,26792,1172,4.1000000000000005,0,1,55656
2025-03-16,AMD RX 6700 XT,88369,4.3,1244,41607,3.9,903,65393,4.7,1831,46762,22976,4.3,0,1,88369
2025-03-16,NVIDIA RTX 4060,67213,4.4,1573,35805,4.2,493,39013,3.6,1594,31408,28200,4.066666666666667,0,1,67213
2025-03-16,AMD RX 7900 XTX,91657,4.7,1222,57903,4.7,349,54229,3.7,217,33754,37428,4.366666666666667,0,1,91657
2025-03-15,NVIDIA RTX 3060,81749,4.6,1072,57783,4.7,1007,35427,4.3,1109,23966,46322,4.533333333333334,0,1,81749
2025-03-15,NVIDIA RTX 3070,83114,4.6,1820,54670,3.8,1605,26874,4.5,1596,28444,56240,4.3,0,1,83114
2025-03-15,NVIDIA RTX 3080,62617,4.2,589,38584,4.5,526,43810,4.2,1503,24033,18807,4.3,0,1,62617
2025-03-15,AMD RX 6600,61595,3.6,685,87161,4.5,739,97500,3.7,128,-25566,-35905,3.9333333333333336,1,150,9239250
2025-03-15,AMD RX 6700 XT,54960,4.0,1928,65643,4.4,186,46986,4.6,1538,-10683,7974,4.333333333333333,0,100,5496000
2025-03-15,NVIDIA RTX 4060,33694,3.7,884,91278,3.9,1407,69227,5.0,1454,-57584,-35533,4.2,1,317,10680998
2025-03-15,AMD RX 7900 XTX,47814,3.8,949,62793,4.0,206,96823,4.4,1343,-14979,-49009,4.066666666666666,1,98,4685772
2025-03-14,NVIDIA RTX 3060,78134,4.3,951,51470,3.9,989,82185,4.5,1906,26664,-4051,4.233333333333333,0,1,78134
2025-03-14,NVIDIA RTX 3070,31855,4.7,897,64657,3.8,665,92461,3.8,851,-32802,-60606,4.1000000000000005,1,196,6243580
2025-03-14,NVIDIA RTX 3080,29276,4.1,112,40924,4.7,118,43682,4.0,204,-11648,-14406,4.266666666666667,1,92,2693392
2025-03-14,AMD RX 6600,70551,4.6,1847,32264,4.7,1073,81466,4.1,864,38287,-10915,4.466666666666667,0,1,70551
2025-03-14,AMD RX 6700 XT,81330,4.6,1218,45357,4.7,609,39609,4.9,611,35973,41721,4.733333333333333,0,1,81330
2025-03-14,NVIDIA RTX 4060,54905,3.8,992,46764,3.6,1366,39824,3.9,701,8141,15081,3.766666666666667,0,10,549050
2025-03-14,AMD RX 7900 XTX,85891,4.1,1469,71478,3.6,828,58446,3.5,1392,14413,27445,3.733333333333333,0,1,85891
2025-03-13,NVIDIA RTX 3060,80926,3.7,1057,47919,4.3,319,75373,4.9,1416,33007,5553,4.3,0,1,80926
2025-03-13,NVIDIA RTX 3070,43825,4.3,1957,42488,3.8,1243,89861,4.9,1927,1337,-46036,4.333333333333333,0,21,920325
2025-03-13,NVIDIA RTX 3080,78493,4.3,155,71116,4.6,143,86469,4.0,1360,7377,-7976,4.3,0,1,78493
2025-03-13,AMD RX 6600,38268,4.1,1875,74448,4.6,613,85030,3.9,319,-36180,-46762,4.2,1,224,8572032
2025-03-13,AMD RX 6700 XT,84003,3.6,876,31150,4.6,1244,25539,4.8,481,52853,58464,4.333333333333333,0,1,84003
2025-03-13,NVIDIA RTX 4060,66639,4.2,791,65074,4.5,488,77603,3.5,982,1565,-10964,4.066666666666666,0,22,1466058
2025-03-13,AMD RX 7900 XTX,73971,4.6,1803,50914,4.0,1599,88111,3.6,1153,23057,-14140,4.066666666666666,0,1,73971
2025-03-12,NVIDIA RTX 3060,79321,4.8,1063,85648,4.8,1326,45511,3.7,1098,-6327,33810,4.433333333333334,0,57,4521297
2025-03-12,NVIDIA RTX 3070,28958,3.6,816,43580,4.3,1020,24179,4.7,612,-14622,4779,4.2,0,94,2722052
2025-03-12,NVIDIA RTX 3080,56714,3.6,1434,62911,4.3,1029,55489,4.1,712,-6197,1225,4.0,0,62,3516268
2025-03-12,AMD RX 6600,27530,4.9,508,27320,4.3,1602,73283,4.8,1198,210,-45753,4.666666666666667,0,25,688250
2025-03-12,AMD RX 6700 XT,29760,3.7,358,46471,4.4,845,58211,5.0,1444,-16711,-28451,4.366666666666667,1,125,3720000
2025-03-12,NVIDIA RTX 4060,89554,3.7,546,55925,4.6,1448,80912,3.7,1630,33629,8642,4.0,0,1,89554
2025-03-12,AMD RX 7900 XTX,88682,3.9,855,74344,4.3,1118,78927,4.0,1882,14338,9755,4.066666666666666,0,1,88682
2025-03-11,NVIDIA RTX 3060,48955,4.4,1631,47224,3.9,939,48919,3.8,182,1731,36,4.033333333333334,0,32,1566560
2025-03-11,NVIDIA RTX 3070,38353,4.9,321,65112,3.6,1449,42753,4.1,778,-26759,-4400,4.2,1,172,6596716
2025-03-11,NVIDIA RTX 3080,27920,4.4,1959,31097,4.8,365,27455,4.5,1081,-3177,465,4.566666666666666,0,66,1842720
2025-03-11,AMD RX 6600,74441,4.9,506,45670,3.8,1094,57811,4.1,1226,28771,16630,4.266666666666667,0,1,74441
2025-03-11,AMD RX 6700 XT,36811,4.5,1384,47923,3.5,1414,92539,4.6,765,-11112,-55728,4.2,1,99,3644289
2025-03-11,NVIDIA RTX 4060,54664,4.5,717,78323,4.2,1377,78523,4.6,1619,-23659,-23859,4.433333333333333,1,160,8746240
2025-03-11,AMD RX 7900 XTX,42502,4.7,811,55948,4.0,1340,74043,3.7,320,-13446,-31541,4.133333333333333,1,115,4887730
2025-03-10,NVIDIA RTX 3060,95336,4.5,241,31396,4.9,527,25805,3.7,1124,63940,69531,4.366666666666667,0,1,95336
2025-03-10,NVIDIA RTX 3070,93621,4.0,1839,87064,4.2,1408,29394,3.9,1489,6557,64227,4.033333333333333,0,1,93621
2025-03-10,NVIDIA RTX 3080,81072,3.7,841,32912,4.3,1923,70364,5.0,1610,48160,10708,4.333333333333333,0,1,81072
2025-03-10,AMD RX 6600,88052,3.7,460,79542,4.7,219,26610,4.2,677,8510,61442,4.2,0,1,88052
2025-03-10,AMD RX 6700 XT,95714,3.9,1755,61173,3.6,244,86367,4.6,607,34541,9347,4.033333333333333,0,1,95714
2025-03-10,NVIDIA RTX 4060,89180,4.2,1597,62471,4.9,1163,47961,4.3,610,26709,41219,4.466666666666668,0,1,89180
2025-03-10,AMD RX 7900 XTX,59819,4.8,1801,35558,4.6,1188,59791,4.8,1535,24261,28,4.733333333333333,0,1,59819
2025-03-09,NVIDIA RTX 3060,35643,4.8,599,74058,3.8,1445,59879,4.7,506,-38415,-24236,4.433333333333334,1,206,7342458
2025-03-09,NVIDIA RTX 3070,87578,4.4,876,59274,4.4,466,89901,4.7,311,28304,-2323,4.5,0,1,87578
2025-03-09,NVIDIA RTX 3080,66327,4.2,765,77283,4.6,1280,92847,3.8,1850,-10956,-26520,4.2,1,69,4576563
2025-03-09,AMD RX 6600,49828,3.8,1733,74443,4.2,1462,43372,3.7,921,-24615,6456,3.9,0,133,6627124
2025-03-09,AMD RX 6700 XT,58650,3.9,1320,78829,3.8,469,29271,5.0,399,-20179,29379,4.233333333333333,0,128,7507200
2025-03-09,NVIDIA RTX 4060,62764,3.5,491,78766,4.0,423,78020,4.4,286,-16002,-15256,3.966666666666667,1,90,5648760
2025-03-09,AMD RX 7900 XTX,35198,4.6,1100,96893,4.2,821,31793,4.1,727,-61695,3405,4.3,0,340,11967320
2025-03-08,NVIDIA RTX 3060,59156,4.2,1557,67813,5.0,764,54149,4.0,1081,-8657,5007,4.3999999999999995,0,83,4909948
2025-03-08,NVIDIA RTX 3070,90003,4.7,290,74099,4.6,981,34217,4.1,205,15904,55786,4.466666666666667,0,1,90003
2025-03-08,NVIDIA RTX 3080,62381,4.1,598,69379,3.9,1217,62784,3.9,674,-6998,-403,3.966666666666667,1,82,5115242
2025-03-08,AMD RX 6600,67574,4.4,1069,53111,4.6,1996,73838,4.1,755,14463,-6264,4.366666666666666,0,1,67574
2025-03-08,AMD RX 6700 XT,94404,4.1,1627,58252,4.9,1016,29721,3.6,206,36152,64683,4.2,0,1,94404
2025-03-08,NVIDIA RTX 4060,68239,4.6,654,74048,4.6,682,65893,3.9,673,-5809,2346,4.366666666666666,0,44,3002516
2025-03-08,AMD RX 7900 XTX,64248,3.8,1577,28376,3.7,1923,38736,3.8,1106,35872,25512,3.766666666666667,0,1,64248
2025-03-07,NVIDIA RTX 3060,49826,3.7,1197,61615,4.0,554,72393,4.0,298,-11789,-22567,3.9,1,82,4085732
2025-03-07,NVIDIA RTX 3070,47836,3.8,1091,52736,3.5,1783,29384,4.3,1865,-4900,18452,3.8666666666666667,0,47,2248292
2025-03-07,NVIDIA RTX 3080,64176,4.4,1656,62705,4.3,1268,41792,4.0,1758,1471,22384,4.233333333333333,0,31,1989456
2025-03-07,AMD RX 6600,95653,3.9,305,43050,3.6,828,74191,4.3,861,52603,21462,3.9333333333333336,0,1,95653
2025-03-07,AMD RX 6700 XT,49869,3.8,467,43594,3.9,1921,58554,3.9,1296,6275,-8685,3.8666666666666667,0,1,49869
2025-03-07,NVIDIA RTX 4060,61733,4.6,359,56657,3.9,715,73052,4.8,367,5076,-11319,4.433333333333334,0,4,246932
2025-03-07,AMD RX 7900 XTX,58326,5.0,1233,38719,4.1,1979,38111,4.4,1968,19607,20215,4.5,0,1,58326
2025-03-06,NVIDIA RTX 3060,66003,4.9,1406,51131,4.6,1723,48540,4.6,1995,14872,17463,4.7,0,1,66003
2025-03-06,NVIDIA RTX 3070,87180,4.8,1275,86662,4.2,1941,35541,4.9,1367,518,51639,4.633333333333334,0,29,2528220
2025-03-06,NVIDIA RTX 3080,63113,4.2,797,39375,4.5,176,69413,4.6,1658,23738,-6300,4.433333333333333,0,1,63113
2025-03-06,AMD RX 6600,46584,3.9,1864,72652,4.7,1987,52846,4.6,189,-26068,-6262,4.3999999999999995,1,148,6894432
2025-03-06,AMD RX 6700 XT,85550,4.7,920,68679,4.8,989,40325,4.1,1557,16871,45225,4.533333333333333,0,1,85550
2025-03-06,NVIDIA RTX 4060,87060,4.4,1505,77581,4.8,564,59689,5.0,1932,9479,27371,4.733333333333333,0,1,87060
2025-03-06,AMD RX 7900 XTX,30268,3.7,1252,28690,4.7,883,73646,4.4,340,1578,-43378,4.266666666666667,0,18,544824
2025-03-05,NVIDIA RTX 3060,62521,5.0,342,31590,4.3,753,79717,4.2,1172,30931,-17196,4.5,0,1,62521
2025-03-05,NVIDIA RTX 3070,81514,4.4,1366,44282,4.3,552,88222,3.8,661,37232,-6708,4.166666666666667,0,1,81514
2025-03-05,NVIDIA RTX 3080,55861,4.1,1960,42492,4.5,904,41271,3.6,1259,13369,14590,4.066666666666666,0,1,55861
2025-03-05,AMD RX 6600,82463,4.8,978,85282,4.4,284,35651,3.8,1768,-2819,46812,4.333333333333333,0,67,5525021
2025-03-05,AMD RX 6700 XT,66684,4.4,1348,54647,3.9,907,78155,4.5,1882,12037,-11471,4.266666666666667,0,1,66684
2025-03-05,NVIDIA RTX 4060,36708,4.4,641,42482,4.0,1074,89917,3.7,1637,-5774,-53209,4.033333333333334,1,71,2606268
2025-03-05,AMD RX 7900 XTX,33927,3.9,1230,32953,4.1,274,91898,4.3,899,974,-57971,4.1000000000000005,0,17,576759
2025-03-04,NVIDIA RTX 3060,33120,3.5,1022,78345,4.2,1529,79514,3.9,476,-45225,-46394,3.8666666666666667,1,236,7816320
2025-03-04,NVIDIA RTX 3070,85977,3.5,690,40192,4.2,505,23781,4.4,1312,45785,62196,4.033333333333334,0,1,85977
2025-03-04,NVIDIA RTX 3080,64814,4.8,245,89182,4.5,501,27361,4.2,1549,-24368,37453,4.5,0,140,9073960
2025-03-04,AMD RX 6600,54762,4.7,1380,92731,3.9,645,92942,4.0,551,-37969,-38180,4.2,1,217,11883354
2025-03-04,AMD RX 6700 XT,51410,3.7,560,81018,4.5,1279,66646,3.9,343,-29608,-15236,4.033333333333333,1,187,9613670
2025-03-04,NVIDIA RTX 4060,43704,4.7,246,34664,4.5,967,46261,3.6,587,9040,-2557,4.266666666666667,0,4,174816
2025-03-04,AMD RX 7900 XTX,31175,4.7,1318,72729,3.8,805,60572,4.5,1909,-41554,-29397,4.333333333333333,1,255,7949625
2025-03-03,NVIDIA RTX 3060,63425,3.7,1510,27669,3.8,816,59495,3.9,1719,35756,3930,3.8000000000000003,0,1,63425
2025-03-03,NVIDIA RTX 3070,67589,4.1,657,85066,3.7,191,34014,5.0,1786,-17477,33575,4.266666666666667,0,115,7772735
2025-03-03,NVIDIA RTX 3080,92020,4.2,264,54238,4.5,419,53900,3.7,1428,37782,38120,4.133333333333333,0,1,92020
2025-03-03,AMD RX 6600,30763,4.6,1336,34167,4.6,597,72724,4.4,855,-3404,-41961,4.533333333333333,1,65,1999595
2025-03-03,AMD RX 6700 XT,55027,3.6,1480,43712,3.5,1520,65221,4.9,1910,11315,-10194,4.0,0,1,55027
2025-03-03,NVIDIA RTX 4060,30226,4.7,1280,39084,4.2,146,62523,3.7,1939,-8858,-32297,4.2,1,61,1843786
2025-03-03,AMD RX 7900 XTX,28708,4.2,1434,67211,4.6,533,63311,5.0,1381,-38503,-34603,4.6000000000000005,1,213,6114804
2025-03-02,NVIDIA RTX 3060,82241,3.8,1298,53188,4.3,629,26276,3.8,672,29053,55965,3.9666666666666663,0,1,82241
2025-03-02,NVIDIA RTX 3070,84332,4.7,286,90414,4.6,389,47262,5.0,1200,-6082,37070,4.766666666666667,0,47,3963604
2025-03-02,NVIDIA RTX 3080,86455,4.1,757,27495,4.4,1458,41870,4.6,882,58960,44585,4.366666666666666,0,1,86455
2025-03-02,AMD RX 6600,37027,4.0,1520,91404,3.9,223,60860,4.5,1228,-54377,-23833,4.133333333333334,1,307,11367289
2025-03-02,AMD RX 6700 XT,89303,4.5,920,60870,4.7,1365,52643,3.8,650,28433,36660,4.333333333333333,0,1,89303
2025-03-02,NVIDIA RTX 4060,30534,3.6,616,57991,4.2,117,53492,4.4,1857,-27457,-22958,4.066666666666667,1,149,4549566
2025-03-02,AMD RX 7900 XTX,65321,5.0,927,33912,4.5,1457,75109,4.2,1594,31409,-9788,4.566666666666666,0,1,65321
2025-03-01,NVIDIA RTX 3060,89458,4.5,1211,70097,3.5,1876,81891,3.7,1081,19361,7567,3.9,0,1,89458
2025-03-01,NVIDIA RTX 3070,85937,3.6,1161,74555,5.0,1141,38342,3.8,478,11382,47595,4.133333333333333,0,1,85937
2025-03-01,NVIDIA RTX 3080,74519,4.6,1380,37639,4.2,1322,46630,4.4,1593,36880,27889,4.4,0,1,74519
2025-03-01,AMD RX 6600,80361,3.8,1224,92393,3.8,1125,50950,3.9,735,-12032,29411,3.8333333333333335,0,81,6509241
2025-03-01,AMD RX 6700 XT,41531,4.2,1530,86622,4.9,144,44809,4.7,1507,-45091,-3278,4.6000000000000005,1,237,9842847
2025-03-01,NVIDIA RTX 4060,86526,3.5,1390,29236,4.9,724,47189,3.7,973,57290,39337,4.033333333333334,0,1,86526
2025-03-01,AMD RX 7900 XTX,59179,3.7,1228,69734,4.1,421,57872,4.9,924,-10555,1307,4.233333333333333,0,65,3846635
2025-02-28,NVIDIA RTX 3060,28316,4.1,560,27248,4.5,827,41070,4.3,1588,1068,-12754,4.3,0,10,283160
2025-02-28,NVIDIA RTX 3070,40651,4.9,1426,63560,5.0,1126,28487,3.6,886,-22909,12164,4.5,0,145,5894395
2025-02-28,NVIDIA RTX 3080,46263,4.9,697,58666,4.4,1899,25616,4.7,1663,-12403,20647,4.666666666666667,0,93,4302459
2025-02-28,AMD RX 6600,94476,3.9,1809,72988,4.9,673,28815,3.9,271,21488,65661,4.233333333333333,0,1,94476
2025-02-28,AMD RX 6700 XT,89110,3.9,1228,52809,4.0,904,58250,4.9,1328,36301,30860,4.266666666666667,0,1,89110
2025-02-28,NVIDIA RTX 4060,44100,3.8,1327,40710,4.6,1166,23845,4.9,317,3390,20255,4.433333333333333,0,10,441000
2025-02-28,AMD RX 7900 XTX,89734,4.8,665,55227,3.9,412,72148,3.6,385,34507,17586,4.1,0,1,89734
2025-02-27,NVIDIA RTX 3060,79171,4.9,1139,80456,4.9,774,89580,4.8,1770,-1285,-10409,4.866666666666667,1,36,2850156
2025-02-27,NVIDIA RTX 3070,57039,3.9,711,85314,3.7,1436,45901,4.0,416,-28275,11138,3.8666666666666667,0,164,9354396
2025-02-27,NVIDIA RTX 3080,87395,4.2,1091,44922,4.3,1738,54413,4.3,647,42473,32982,4.266666666666667,0,1,87395
2025-02-27,AMD RX 6600,69959,4.3,1212,49648,4.0,1544,38304,4.7,310,20311,31655,4.333333333333333,0,1,69959
2025-02-27,AMD RX 6700 XT,75171,4.9,1880,91763,4.1,1961,61734,4.3,1813,-16592,13437,4.433333333333334,0,96,7216416
2025-02-27,NVIDIA RTX 4060,52440,3.9,884,46400,4.9,1978,77593,3.5,559,6040,-25153,4.1000000000000005,0,1,52440
2025-02-27,AMD RX 7900 XTX,55978,3.6,1625,45315,3.6,1191,27001,4.1,401,10663,28977,3.766666666666667,0,1,55978
2025-02-26,NVIDIA RTX 3060,89770,4.9,880,39025,4.0,1901,73677,3.9,1987,50745,16093,4.266666666666667,0,1,89770
2025-02-26,NVIDIA RTX 3070,78040,4.7,1435,47029,3.5,752,78054,4.8,1785,31011,-14,4.333333333333333,0,1,78040
2025-02-26,NVIDIA RTX 3080,45993,4.9,358,79637,4.0,1627,40761,3.8,325,-33644,5232,4.233333333333333,0,212,9750516
2025-02-26,AMD RX 6600,92670,4.0,305,59131,4.7,318,52261,4.9,677,33539,40409,4.533333333333333,0,1,92670
2025-02-26,AMD RX 6700 XT,80527,4.3,1035,40754,3.5,1353,69457,4.4,342,39773,11070,4.066666666666666,0,1,80527
2025-02-26,NVIDIA RTX 4060,29929,3.7,1883,61939,4.4,572,69944,4.8,1338,-32010,-40015,4.300000000000001,1,188,5626652
2025-02-26,AMD RX 7900 XTX,42844,4.2,642,54323,4.5,835,43263,4.1,785,-11479,-419,4.266666666666667,1,92,3941648
2025-02-25,NVIDIA RTX 3060,71480,4.5,1430,38054,4.7,374,51336,4.1,1929,33426,20144,4.433333333333333,0,1,71480
2025-02-25,NVIDIA RTX 3070,35218,4.8,1859,92793,4.2,1430,66644,4.7,813,-57575,-31426,4.566666666666666,1,339,11938902
2025-02-25,NVIDIA RTX 3080,95055,4.9,1383,72522,4.8,1106,37841,4.9,1455,22533,57214,4.866666666666666,0,1,95055
2025-02-25,AMD RX 6600,90388,3.6,240,85234,3.7,563,72554,4.7,1556,5154,17834,4.0,0,13,1175044
2025-02-25,AMD RX 6700 XT,57941,4.5,688,29571,4.6,130,32026,4.8,404,28370,25915,4.633333333333333,0,1,57941
2025-02-25,NVIDIA RTX 4060,52557,4.2,301,60753,3.8,1474,43836,3.7,1014,-8196,8721,3.9,0,86,4519902
2025-02-25,AMD RX 7900 XTX,38807,3.7,713,50260,3.6,1998,85260,3.7,975,-11453,-46453,3.6666666666666665,1,77,2988139
2025-02-24,NVIDIA RTX 3060,26170,4.0,214,84631,4.2,765,59685,3.6,361,-58461,-33515,3.933333333333333,1,326,8531420
2025-02-24,NVIDIA RTX 3070,63388,4.1,398,83992,4.1,1689,48992,4.0,1112,-20604,14396,4.066666666666666,0,137,8684156
2025-02-24,NVIDIA RTX 3080,58358,4.1,1496,32462,4.6,879,81494,4.5,947,25896,-23136,4.3999999999999995,0,1,58358
2025-02-24,AMD RX 6600,46992,3.8,1348,66240,4.4,1620,66839,4.7,1439,-19248,-19847,4.3,1,140,6578880
2025-02-24,AMD RX 6700 XT,77216,4.5,1119,96097,4.8,1711,57370,4.1,1118,-18881,19846,4.466666666666667,0,115,8879840
2025-02-24,NVIDIA RTX 4060,42660,4.2,620,31312,3.7,1035,95997,4.3,1782,11348,-53337,4.066666666666666,0,1,42660
2025-02-24,AMD RX 7900 XTX,84327,4.5,1940,29571,4.3,910,55311,3.6,1564,54756,29016,4.133333333333334,0,1,84327
2025-02-23,NVIDIA RTX 3060,85337,4.5,423,31712,4.1,1667,81607,4.4,1520,53625,3730,4.333333333333333,0,1,85337
2025-02-23,NVIDIA RTX 3070,35299,4.9,1303,30016,3.9,915,56507,3.6,840,5283,-21208,4.133333333333334,0,13,458887
2025-02-23,NVIDIA RTX 3080,66444,4.9,1513,64260,4.2,965,24040,5.0,135,2184,42404,4.7,0,13,863772
2025-02-23,AMD RX 6600,58522,4.8,507,65612,4.9,1513,74074,4.2,373,-7090,-15552,4.633333333333333,1,85,4974370
2025-02-23,AMD RX 6700 XT,76380,3.7,881,90925,4.2,1423,36926,4.9,839,-14545,39454,4.266666666666667,0,108,8249040
2025-02-23,NVIDIA RTX 4060,73757,3.9,1532,81944,4.6,331,42678,4.2,1810,-8187,31079,4.233333333333333,0,74,5458018
2025-02-23,AMD RX 7900 XTX,60875,5.0,1448,50357,4.9,1525,79177,3.8,559,10518,-18302,4.566666666666666,0,1,60875
2025-02-22,NVIDIA RTX 3060,76127,3.5,1871,42954,4.1,1023,30450,3.7,1524,33173,45677,3.766666666666667,0,1,76127
2025-02-22,NVIDIA RTX 3070,33395,4.6,1805,26730,4.2,1936,43845,4.6,1525,6665,-10450,4.466666666666667,0,1,33395
2025-02-22,NVIDIA RTX 3080,61397,4.4,821,52191,3.6,763,80711,3.6,317,9206,-19314,3.8666666666666667,0,1,61397
2025-02-22,AMD RX 6600,55920,3.8,613,49379,4.6,286,35575,4.8,1882,6541,20345,4.3999999999999995,0,9,503280
2025-02-22,AMD RX 6700 XT,45073,3.6,1385,42748,4.2,843,42979,3.7,389,2325,2094,3.8333333333333335,0,32,1442336
2025-02-22,NVIDIA RTX 4060,29697,4.7,168,37472,4.6,1588,34360,3.6,1265,-7775,-4663,4.3,1,77,2286669
2025-02-22,AMD RX 7900 XTX,75822,3.7,1962,94079,4.9,875,77816,4.6,1062,-18257,-1994,4.4,1,124,9401928
2025-02-21,NVIDIA RTX 3060,63356,4.6,459,72245,4.7,1968,44684,4.5,713,-8889,18672,4.6000000000000005,0,84,5321904
2025-02-21,NVIDIA RTX 3070,49400,4.7,1894,70566,4.8,1866,86999,4.6,1009,-21166,-37599,4.7,1,123,6076200
2025-02-21,NVIDIA RTX 3080,74301,4.3,658,43000,4.8,466,26080,3.7,222,31301,48221,4.266666666666667,0,1,74301
2025-02-21,AMD RX 6600,45672,4.9,1086,32162,4.0,1595,31158,4.6,1130,13510,14514,4.5,0,1,45672
2025-02-21,AMD RX 6700 XT,63458,4.7,1059,82856,4.4,340,43106,4.1,967,-19398,20352,4.4,0,117,7424586
2025-02-21,NVIDIA RTX 4060,33022,4.6,562,40906,3.5,1667,86084,4.6,628,-7884,-53062,4.233333333333333,1,73,2410606
2025-02-21,AMD RX 7900 XTX,78654,4.0,1719,55275,4.2,1851,90288,4.6,967,23379,-11634,4.266666666666667,0,1,78654
2025-02-20,NVIDIA RTX 3060,73831,3.9,353,91810,4.7,1345,44778,5.0,1168,-17979,29053,4.533333333333333,0,129,9524199
2025-02-20,NVIDIA RTX 3070,84628,4.5,1476,88627,3.8,1450,72512,4.6,920,-3999,12116,4.3,0,60,5077680
2025-02-20,NVIDIA RTX 3080,61150,4.1,1407,88069,4.1,262,31132,4.1,1784,-26919,30018,4.1,0,180,11007000
2025-02-20,AMD RX 6600,71576,4.5,1065,24865,4.8,669,37791,4.2,741,46711,33785,4.5,0,1,71576
2025-02-20,AMD RX 6700 XT,30355,4.8,1249,49615,3.8,212,78213,3.7,1745,-19260,-47858,4.1000000000000005,1,111,3369405
2025-02-20,NVIDIA RTX 4060,69989,3.8,229,68046,3.7,166,75987,4.1,652,1943,-5998,3.8666666666666667,0,22,1539758
2025-02-20,AMD RX 7900 XTX,88595,4.0,936,63829,4.9,200,37063,3.6,1335,24766,51532,4.166666666666667,0,1,88595
2025-02-19,NVIDIA RTX 3060,38437,3.6,176,39687,5.0,430,66199,3.9,433,-1250,-27762,4.166666666666667,1,56,2152472
2025-02-19,NVIDIA RTX 3070,65928,3.7,580,64280,4.5,1533,36489,3.8,122,1648,29439,4.0,0,11,725208
2025-02-19,NVIDIA RTX 3080,42964,4.2,1473,48984,4.6,837,64053,4.3,1407,-6020,-21089,4.366666666666667,1,79,3394156
2025-02-19,AMD RX 6600,81746,4.6,416,27459,4.7,761,28210,3.9,1267,54287,53536,4.4,0,1,81746
2025-02-19,AMD RX 6700 XT,81744,3.6,1102,73413,4.7,1653,32499,5.0,1090,8331,49245,4.433333333333334,0,2,163488
2025-02-19,NVIDIA RTX 4060,77783,3.5,858,82519,3.6,1064,28380,4.0,732,-4736,49403,3.6999999999999997,0,73,5678159
2025-02-19,AMD RX 7900 XTX,54109,4.2,583,40634,4.5,662,26032,4.6,915,13475,28077,4.433333333333333,0,1,54109
2025-02-18,NVIDIA RTX 3060,70350,5.0,852,69467,4.1,529,89160,4.0,900,883,-18810,4.366666666666666,0,45,3165750
2025-02-18,NVIDIA RTX 3070,69508,4.1,488,54413,3.6,1270,69701,4.6,299,15095,-193,4.1,0,1,69508
2025-02-18,NVIDIA RTX 3080,41736,3.6,534,92048,4.2,1510,68762,4.8,1131,-50312,-27026,4.2,1,274,11435664
2025-02-18,AMD RX 6600,25213,4.7,598,63140,4.4,748,39351,4.7,407,-37927,-14138,4.6000000000000005,1,227,5723351
2025-02-18,AMD RX 6700 XT,43130,3.8,1799,60338,4.4,1376,29914,4.7,1076,-17208,13216,4.3,0,101,4356130
2025-02-18,NVIDIA RTX 4060,53955,3.8,1881,69442,4.4,1116,29279,3.7,1497,-15487,24676,3.9666666666666663,0,114,6150870
2025-02-18,AMD RX 7900 XTX,55230,4.7,1715,96091,4.4,1108,83345,4.8,291,-40861,-28115,4.633333333333334,1,224,12371520
2025-02-17,NVIDIA RTX 3060,24642,4.8,396,50572,3.8,694,54118,4.7,1439,-25930,-29476,4.433333333333334,1,174,4287708
2025-02-17,NVIDIA RTX 3070,43463,3.9,457,47381,3.7,1052,46349,3.7,1127,-3918,-2886,3.766666666666667,1,64,2781632
2025-02-17,NVIDIA RTX 3080,41823,4.8,369,39154,4.7,949,95641,4.4,1171,2669,-53818,4.633333333333334,0,1,41823
2025-02-17,AMD RX 6600,26881,4.7,587,76641,4.0,1247,70414,4.7,794,-49760,-43533,4.466666666666666,1,294,7903014
2025-02-17,AMD RX 6700 XT,64566,3.8,207,49923,4.5,1513,63072,4.4,982,14643,1494,4.233333333333333,0,1,64566
2025-02-17,NVIDIA RTX 4060,42062,4.3,1627,60997,4.7,730,33082,4.7,893,-18935,8980,4.566666666666666,0,142,5972804
2025-02-17,AMD RX 7900 XTX,34231,4.2,841,65508,4.3,1670,55050,5.0,1342,-31277,-20819,4.5,1,168,5750808
2025-02-16,NVIDIA RTX 3060,94134,3.7,1131,23735,4.5,799,33078,4.4,1118,70399,61056,4.2,0,1,94134
2025-02-16,NVIDIA RTX 3070,56076,3.6,1704,79844,4.4,159,34889,3.7,1882,-23768,21187,3.9,0,164,9196464
2025-02-16,NVIDIA RTX 3080,92817,4.2,163,46609,4.0,792,67054,4.8,1733,46208,25763,4.333333333333333,0,1,92817
2025-02-16,AMD RX 6600,33895,4.8,973,88684,4.7,1422,37512,3.6,742,-54789,-3617,4.366666666666666,1,301,10202395
2025-02-16,AMD RX 6700 XT,40166,4.6,1008,43737,3.7,1043,46666,3.7,673,-3571,-6500,4.0,1,51,2048466
2025-02-16,NVIDIA RTX 4060,32293,4.0,403,69711,4.7,947,72516,3.6,466,-37418,-40223,4.1,1,229,7395097
2025-02-16,AMD RX 7900 XTX,31642,3.9,1396,33610,3.9,1584,84503,5.0,624,-1968,-52861,4.266666666666667,1,27,854334
2025-02-15,NVIDIA RTX 3060,67742,5.0,1186,67901,4.3,526,85266,4.9,353,-159,-17524,4.733333333333333,1,34,2303228
2025-02-15,NVIDIA RTX 3070,64368,4.3,981,68375,3.6,405,86321,4.0,687,-4007,-21953,3.966666666666667,1,55,3540240
2025-02-15,NVIDIA RTX 3080,40747,3.7,1440,59015,4.0,868,77901,4.8,1978,-18268,-37154,4.166666666666667,1,136,5541592
2025-02-15,AMD RX 6600,53706,4.2,567,48430,4.4,483,42517,4.1,1830,5276,11189,4.233333333333333,0,10,537060
2025-02-15,AMD RX 6700 XT,79015,4.7,916,39840,4.6,744,66171,3.6,946,39175,12844,4.3,0,1,79015
2025-02-15,NVIDIA RTX 4060,82500,3.6,974,28369,4.1,1117,92001,3.9,1893,54131,-9501,3.8666666666666667,0,1,82500
2025-02-15,AMD RX 7900 XTX,68411,3.9,412,56192,4.2,719,32677,5.0,216,12219,35734,4.366666666666666,0,1,68411
2025-02-14,NVIDIA RTX 3060,84712,3.6,274,54630,4.0,329,59820,4.7,116,30082,24892,4.1000000000000005,0,1,84712
2025-02-14,NVIDIA RTX 3070,37756,3.6,1613,71355,4.7,1970,43120,3.9,424,-33599,-5364,4.066666666666667,1,200,7551200
2025-02-14,NVIDIA RTX 3080,71908,4.3,1301,37772,4.3,1736,74931,3.8,1890,34136,-3023,4.133333333333333,0,1,71908
2025-02-14,AMD RX 6600,70695,3.7,824,89359,3.7,796,88072,3.6,1054,-18664,-17377,3.6666666666666665,1,109,7705755
2025-02-14,AMD RX 6700 XT,83341,3.6,689,91369,4.8,735,88668,4.3,1775,-8028,-5327,4.233333333333333,1,64,5333824
2025-02-14,NVIDIA RTX 4060,65833,3.7,1139,66077,4.7,301,83822,3.6,1598,-244,-17989,4.0,1,51,3357483
2025-02-14,AMD RX 7900 XTX,51151,4.5,559,95195,5.0,520,39452,4.7,508,-44044,11699,4.733333333333333,0,261,13350411
2025-02-13,NVIDIA RTX 3060,39052,4.8,852,30554,4.1,1871,77320,3.6,801,8498,-38268,4.166666666666666,0,1,39052
2025-02-13,NVIDIA RTX 3070,39340,4.4,1753,91412,3.5,190,87480,4.6,1075,-52072,-48140,4.166666666666667,1,284,11172560
2025-02-13,NVIDIA RTX 3080,82839,5.0,1776,36143,4.2,194,39264,4.2,1216,46696,43575,4.466666666666666,0,1,82839
2025-02-13,AMD RX 6600,30429,4.9,1798,39777,4.6,1626,46262,3.7,537,-9348,-15833,4.3999999999999995,1,92,2799468
2025-02-13,AMD RX 6700 XT,57291,3.8,1539,63141,4.4,739,68621,3.5,1331,-5850,-11330,3.9,1,46,2635386
2025-02-13,NVIDIA RTX 4060,65282,4.0,471,52132,3.8,686,72355,4.9,840,13150,-7073,4.233333333333333,0,1,65282
2025-02-13,AMD RX 7900 XTX,45415,4.5,242,62621,4.0,1003,82253,3.8,533,-17206,-36838,4.1000000000000005,1,107,4859405
2025-02-12,NVIDIA RTX 3060,45781,5.0,287,39653,3.7,660,30607,4.1,616,6128,15174,4.266666666666667,0,1,45781
2025-02-12,NVIDIA RTX 3070,93293,4.1,1029,37126,4.9,1246,45766,3.7,660,56167,47527,4.233333333333333,0,1,93293
2025-02-12,NVIDIA RTX 3080,67970,4.1,1577,90216,3.8,817,75762,3.9,1558,-22246,-7792,3.933333333333333,1,137,9311890
2025-02-12,AMD RX 6600,69166,4.4,1909,65964,3.7,1542,84606,4.3,1471,3202,-15440,4.133333333333334,0,21,1452486
2025-02-12,AMD RX 6700 XT,30169,3.7,1365,63830,3.9,245,57513,4.7,289,-33661,-27344,4.1000000000000005,1,197,5943293
2025-02-12,NVIDIA RTX 4060,34043,3.6,1007,67835,4.8,1207,80969,4.9,708,-33792,-46926,4.433333333333334,1,192,6536256
2025-02-12,AMD RX 7900 XTX,81554,4.4,948,80564,3.7,1064,45191,4.0,958,990,36363,4.033333333333334,0,41,3343714
2025-02-11,NVIDIA RTX 3060,59569,4.6,333,29480,4.1,276,89022,4.3,1705,30089,-29453,4.333333333333333,0,1,59569
2025-02-11,NVIDIA RTX 3070,70763,3.7,1488,81107,3.8,1320,48768,4.2,1969,-10344,21995,3.9,0,68,4811884
2025-02-11,NVIDIA RTX 3080,90099,4.5,193,85484,4.0,780,73086,4.3,1930,4615,17013,4.266666666666667,0,1,90099
2025-02-11,AMD RX 6600,54140,5.0,212,53811,4.6,1757,48662,4.6,1284,329,5478,4.733333333333333,0,13,703820
2025-02-11,AMD RX 6700 XT,24681,4.0,532,92567,5.0,1647,43607,4.5,1786,-67886,-18926,4.5,1,351,8663031
2025-02-11,NVIDIA RTX 4060,42080,3.9,345,87690,3.7,1764,63602,3.7,1039,-45610,-21522,3.766666666666667,1,240,10099200
2025-02-11,AMD RX 7900 XTX,27087,4.6,459,84173,4.2,1501,45422,4.8,332,-57086,-18335,4.533333333333334,1,316,8559492
2025-02-10,NVIDIA RTX 3060,42046,4.3,571,86854,3.8,558,77417,4.3,107,-44808,-35371,4.133333333333333,1,243,10217178
2025-02-10,NVIDIA RTX 3070,92147,4.8,1751,45890,3.9,844,82084,4.5,1408,46257,10063,4.3999999999999995,0,1,92147
2025-02-10,NVIDIA RTX 3080,69011,4.1,1619,74892,4.5,1462,35070,3.8,484,-5881,33941,4.133333333333333,0,51,3519561
2025-02-10,AMD RX 6600,31117,3.5,1986,67956,4.2,161,82778,4.3,440,-36839,-51661,4.0,1,198,6161166
2025-02-10,AMD RX 6700 XT,34769,4.4,1274,34460,3.7,1080,73257,4.0,491,309,-38488,4.033333333333334,0,14,486766
2025-02-10,NVIDIA RTX 4060,80820,4.5,692,83854,3.9,813,26916,4.7,133,-3034,53904,4.366666666666667,0,43,3475260
2025-02-10,AMD RX 7900 XTX,40414,3.5,765,42858,3.7,1774,64090,4.3,1877,-2444,-23676,3.8333333333333335,1,50,2020700
2025-02-09,NVIDIA RTX 3060,49590,4.2,1512,38691,4.3,245,44078,4.2,1033,10899,5512,4.233333333333333,0,1,49590
2025-02-09,NVIDIA RTX 3070,70149,4.2,316,65963,4.2,1309,79631,4.0,1796,4186,-9482,4.133333333333334,0,17,1192533
2025-02-09,NVIDIA RTX 3080,57460,4.4,1173,78144,4.4,1222,82101,5.0,787,-20684,-24641,4.6000000000000005,1,137,7872020
2025-02-09,AMD RX 6600,35550,4.8,1627,46794,4.1,797,38300,4.2,864,-11244,-2750,4.366666666666666,1,94,3341700
2025-02-09,AMD RX 6700 XT,68315,4.0,444,54979,4.4,1706,49714,4.4,1211,13336,18601,4.266666666666667,0,1,68315
2025-02-09,NVIDIA RTX 4060,36192,4.4,1186,83708,4.7,1215,82256,3.9,1450,-47516,-46064,4.333333333333334,1,287,10387104
2025-02-09,AMD RX 7900 XTX,90428,4.9,815,54370,4.5,259,84537,3.9,1370,36058,5891,4.433333333333334,0,1,90428
2025-02-08,NVIDIA RTX 3060,73977,4.9,1421,86719,4.4,1048,35722,4.7,312,-12742,38255,4.666666666666667,0,98,7249746
2025-02-08,NVIDIA RTX 3070,43293,3.7,624,69194,3.6,1011,39070,3.5,942,-25901,4223,3.6,0,164,7100052
2025-02-08,NVIDIA RTX 3080,49277,4.4,1656,47614,4.9,242,39654,4.6,1377,1663,9623,4.633333333333334,0,26,1281202
2025-02-08,AMD RX 6600,33327,4.9,1386,41868,4.7,1679,40257,4.2,1290,-8541,-6930,4.6000000000000005,1,69,2299563
2025-02-08,AMD RX 6700 XT,90564,4.6,1656,74346,4.2,1452,31746,3.9,961,16218,58818,4.233333333333333,0,1,90564
2025-02-08,NVIDIA RTX 4060,86417,4.9,1256,30799,3.8,384,51595,4.7,1229,55618,34822,4.466666666666666,0,1,86417
2025-02-08,AMD RX 7900 XTX,69501,4.0,1000,23225,4.5,1027,72885,3.8,1061,46276,-3384,4.1000000000000005,0,1,69501
2025-02-07,NVIDIA RTX 3060,34791,4.2,720,94019,4.1,1283,41182,5.0,1971,-59228,-6391,4.433333333333334,1,344,11968104
2025-02-07,NVIDIA RTX 3070,62846,3.6,1139,82212,3.8,1896,86192,4.9,1420,-19366,-23346,4.1000000000000005,1,137,8609902
2025-02-07,NVIDIA RTX 3080,34266,4.2,177,65952,4.4,1970,73941,4.9,1701,-31686,-39675,4.500000000000001,1,210,7195860
2025-02-07,AMD RX 6600,32476,4.7,257,65478,4.6,1974,55508,3.9,1901,-33002,-23032,4.4,1,217,7047292
2025-02-07,AMD RX 6700 XT,38873,4.4,887,67854,4.4,1352,59186,4.8,1728,-28981,-20313,4.533333333333334,1,194,7541362
2025-02-07,NVIDIA RTX 4060,87402,4.3,1721,92213,4.8,1845,81872,3.9,1943,-4811,5530,4.333333333333333,0,38,3321276
2025-02-07,AMD RX 7900 XTX,31060,4.9,1270,61070,4.1,1224,76603,3.5,414,-30010,-45543,4.166666666666667,1,194,6025640
2025-02-06,NVIDIA RTX 3060,49305,4.4,1126,28969,4.6,1780,75325,4.7,1328,20336,-26020,4.566666666666666,0,1,49305
2025-02-06,NVIDIA RTX 3070,42279,4.2,1760,69984,4.8,1872,66356,3.8,1271,-27705,-24077,4.266666666666667,1,181,7652499
2025-02-06,NVIDIA RTX 3080,72866,3.6,1423,28014,4.1,1308,80344,4.3,901,44852,-7478,4.0,0,1,72866
2025-02-06,AMD RX 6600,44937,3.9,996,78798,4.0,883,52300,4.5,1796,-33861,-7363,4.133333333333334,1,202,9077274
2025-02-06,AMD RX 6700 XT,83888,4.3,425,78344,4.2,532,33493,4.1,1403,5544,50395,4.2,0,1,83888
2025-02-06,NVIDIA RTX 4060,72750,4.9,893,48619,3.7,1237,79136,3.8,1951,24131,-6386,4.133333333333334,0,1,72750
2025-02-06,AMD RX 7900 XTX,78349,4.5,207,75360,4.8,415,67934,3.7,573,2989,10415,4.333333333333333,0,27,2115423
2025-02-05,NVIDIA RTX 3060,66402,4.0,1242,65299,3.7,123,40867,4.7,1132,1103,25535,4.133333333333334,0,29,1925658
2025-02-05,NVIDIA RTX 3070,74994,3.9,1844,36714,3.5,1577,42687,4.4,902,38280,32307,3.9333333333333336,0,1,74994
2025-02-05,NVIDIA RTX 3080,44439,3.6,1459,91181,4.2,378,60637,3.7,760,-46742,-16198,3.8333333333333335,1,249,11065311
2025-02-05,AMD RX 6600,43402,4.0,1443,34221,4.5,951,49470,3.6,995,9181,-6068,4.033333333333333,0,1,43402
2025-02-05,AMD RX 6700 XT,74430,4.4,273,87468,4.4,971,28663,4.7,413,-13038,45767,4.5,0,114,8485020
2025-02-05,NVIDIA RTX 4060,67155,4.1,1721,49288,4.3,1230,30709,4.6,1985,17867,36446,4.333333333333333,0,1,67155
2025-02-05,AMD RX 7900 XTX,66100,4.5,1797,84139,4.0,480,37008,4.1,1620,-18039,29092,4.2,0,124,8196400
2025-02-04,NVIDIA RTX 3060,91760,4.5,967,82627,3.5,1120,42827,4.5,1692,9133,48933,4.166666666666667,0,1,91760
2025-02-04,NVIDIA RTX 3070,91612,3.5,732,58864,4.3,941,70467,3.9,1938,32748,21145,3.9,0,1,91612
2025-02-04,NVIDIA RTX 3080,47381,4.0,1669,70373,5.0,1263,53497,3.8,1821,-22992,-6116,4.266666666666667,1,150,7107150
2025-02-04,AMD RX 6600,87308,3.8,381,91116,4.1,1288,60094,4.7,1709,-3808,27214,4.2,0,31,2706548
2025-02-04,AMD RX 6700 XT,42940,3.9,1714,90771,3.6,1595,73692,4.5,663,-47831,-30752,4.0,1,281,12066140
2025-02-04,NVIDIA RTX 4060,39414,4.7,1810,93286,4.2,260,34051,4.4,1407,-53872,5363,4.433333333333334,0,287,11311818
2025-02-04,AMD RX 7900 XTX,91322,4.5,1894,95594,3.6,1067,36463,4.2,1320,-4272,54859,4.1000000000000005,0,63,5753286
2025-02-03,NVIDIA RTX 3060,44068,4.1,432,37837,4.5,1734,38957,3.7,636,6231,5111,4.1000000000000005,0,1,44068
2025-02-03,NVIDIA RTX 3070,51378,4.7,1756,67981,3.6,803,46435,3.6,1829,-16603,4943,3.966666666666667,0,130,6679140
2025-02-03,NVIDIA RTX 3080,49604,4.2,941,27253,4.2,1955,71072,4.1,1105,22351,-21468,4.166666666666667,0,1,49604
2025-02-03,AMD RX 6600,75289,4.6,1009,88204,4.6,962,28266,3.6,1381,-12915,47023,4.266666666666667,0,82,6173698
2025-02-03,AMD RX 6700 XT,63023,3.9,589,70670,3.9,172,33724,4.5,868,-7647,29299,4.1000000000000005,0,64,4033472
2025-02-03,NVIDIA RTX 4060,66404,4.9,497,67810,4.7,633,68292,4.9,1755,-1406,-1888,4.833333333333334,1,60,3984240
2025-02-03,AMD RX 7900 XTX,75769,4.9,1002,35205,4.2,446,44588,3.9,1950,40564,31181,4.333333333333334,0,1,75769
2025-02-02,NVIDIA RTX 3060,84821,4.7,1129,34141,5.0,1756,50822,4.4,1342,50680,33999,4.7,0,1,84821
2025-02-02,NVIDIA RTX 3070,94564,4.9,1772,27927,4.2,359,27082,5.0,810,66637,67482,4.7,0,1,94564
2025-02-02,NVIDIA RTX 3080,53127,3.7,612,88898,4.8,669,90456,4.4,110,-35771,-37329,4.3,1,210,11156670
2025-02-02,AMD RX 6600,34091,4.2,860,56121,4.4,663,47034,4.6,1997,-22030,-12943,4.4,1,136,4636376
2025-02-02,AMD RX 6700 XT,41273,4.8,1843,55795,4.6,1336,39516,4.4,1197,-14522,1757,4.6,0,123,5076579
2025-02-02,NVIDIA RTX 4060,40676,3.6,428,49733,4.6,1449,29262,4.3,412,-9057,11414,4.166666666666667,0,85,3457460
2025-02-02,AMD RX 7900 XTX,61435,4.9,401,83572,4.7,635,53340,3.7,544,-22137,8095,4.433333333333334,0,126,7740810
2025-02-01,NVIDIA RTX 3060,80091,4.9,554,56930,3.8,1180,28549,3.7,270,23161,51542,4.133333333333333,0,1,80091
2025-02-01,NVIDIA RTX 3070,83993,4.9,949,29145,5.0,397,40783,3.9,508,54848,43210,4.6000000000000005,0,1,83993
2025-02-01,NVIDIA RTX 3080,32227,4.3,582,46266,4.6,945,36909,4.6,1435,-14039,-4682,4.499999999999999,1,117,3770559
2025-02-01,AMD RX 6600,73283,4.1,157,74171,4.5,1586,64403,4.6,1115,-888,8880,4.3999999999999995,0,43,3151169
2025-02-01,AMD RX 6700 XT,64581,4.8,1431,45653,4.4,1824,83354,4.9,1988,18928,-18773,4.7,0,1,64581
2025-02-01,NVIDIA RTX 4060,67143,3.7,687,67674,4.5,1647,49352,3.8,1507,-531,17791,4.0,0,52,3491436
2025-02-01,AMD RX 7900 XTX,89627,4.7,1654,37633,3.8,916,62060,3.7,1724,51994,27567,4.066666666666666,0,1,89627
2025-01-31,NVIDIA RTX 3060,87161,4.4,1955,86888,4.2,1640,64197,4.7,1578,273,22964,4.433333333333334,0,16,1394576
2025-01-31,NVIDIA RTX 3070,32539,3.9,1810,93712,4.1,1545,89491,4.8,967,-61173,-56952,4.266666666666667,1,316,10282324
2025-01-31,NVIDIA RTX 3080,46092,4.9,1346,77014,3.9,1186,60219,4.4,1343,-30922,-14127,4.4,1,176,8112192
2025-01-31,AMD RX 6600,94643,3.7,690,79078,3.9,1732,75722,3.8,822,15565,18921,3.7999999999999994,0,1,94643
2025-01-31,AMD RX 6700 XT,55614,3.7,588,83956,4.5,1185,76198,4.7,1020,-28342,-20584,4.3,1,153,8508942
2025-01-31,NVIDIA RTX 4060,82261,4.7,1036,28173,4.9,1405,44197,4.9,618,54088,38064,4.833333333333334,0,1,82261
2025-01-31,AMD RX 7900 XTX,31140,4.8,1123,71913,4.4,1435,78118,4.4,1896,-40773,-46978,4.533333333333333,1,245,7629300
2025-01-30,NVIDIA RTX 3060,29330,4.3,595,60472,3.9,1743,94418,4.1,334,-31142,-65088,4.1,1,171,5015430
2025-01-30,NVIDIA RTX 3070,43204,4.1,1359,36972,4.5,901,48223,4.1,480,6232,-5019,4.233333333333333,0,12,518448
2025-01-30,NVIDIA RTX 3080,70214,4.4,483,87969,4.6,1603,70899,3.6,1445,-17755,-685,4.2,1,112,7863968
2025-01-30,AMD RX 6600,37509,5.0,238,51808,4.0,1513,73761,3.7,743,-14299,-36252,4.233333333333333,1,114,4276026
2025-01-30,AMD RX 6700 XT,95408,4.3,1139,48148,4.3,1477,38108,4.0,122,47260,57300,4.2,0,1,95408
2025-01-30,NVIDIA RTX 4060,27863,4.8,189,23666,3.5,300,66856,4.2,1728,4197,-38993,4.166666666666667,0,28,780164
2025-01-30,AMD RX 7900 XTX,75767,3.9,133,91698,4.5,819,66052,4.3,889,-15931,9715,4.233333333333333,0,114,8637438
2025-01-29,NVIDIA RTX 3060,69358,4.0,1601,56700,3.9,495,64102,3.8,545,12658,5256,3.9,0,1,69358
2025-01-29,NVIDIA RTX 3070,40353,4.6,780,26655,4.4,216,40084,3.9,1344,13698,269,4.3,0,1,40353
2025-01-29,NVIDIA RTX 3080,39849,4.0,793,55329,4.5,1550,36508,4.8,963,-15480,3341,4.433333333333334,0,104,4144296
2025-01-29,AMD RX 6600,50557,4.2,1524,38432,4.8,366,81646,4.7,505,12125,-31089,4.566666666666666,0,1,50557
2025-01-29,AMD RX 6700 XT,89897,3.8,376,76654,4.6,1426,48243,4.7,1121,13243,41654,4.366666666666666,0,1,89897
2025-01-29,NVIDIA RTX 4060,36135,4.7,1037,47125,4.5,618,30381,4.1,354,-10990,5754,4.433333333333333,0,100,3613500
2025-01-29,AMD RX 7900 XTX,29250,3.8,1720,64434,4.5,255,82748,4.4,1310,-35184,-53498,4.233333333333333,1,217,6347250
2025-01-28,NVIDIA RTX 3060,48487,4.0,735,83697,4.7,1517,74117,4.4,683,-35210,-25630,4.366666666666666,1,198,9600426
2025-01-28,NVIDIA RTX 3070,92814,5.0,1212,66497,3.7,251,29609,4.7,1279,26317,63205,4.466666666666666,0,1,92814
2025-01-28,NVIDIA RTX 3080,86124,3.6,1424,58855,4.1,781,26391,3.9,1823,27269,59733,3.8666666666666667,0,1,86124
2025-01-28,AMD RX 6600,49391,4.0,1699,31987,4.9,642,75100,4.8,1980,17404,-25709,4.566666666666666,0,1,49391
2025-01-28,AMD RX 6700 XT,33636,4.0,354,48930,3.6,510,91462,4.0,133,-15294,-57826,3.8666666666666667,1,89,2993604
2025-01-28,NVIDIA RTX 4060,73816,4.8,1622,74924,4.5,322,34952,3.6,1743,-1108,38864,4.3,0,36,2657376
2025-01-28,AMD RX 7900 XTX,82804,4.0,482,45285,4.7,547,82329,4.0,749,37519,475,4.233333333333333,0,1,82804
2025-01-27,NVIDIA RTX 3060,92707,4.2,1992,39543,4.6,311,70606,3.6,1686,53164,22101,4.133333333333334,0,1,92707
2025-01-27,NVIDIA RTX 3070,92246,4.7,1589,27166,3.6,1590,67093,4.4,905,65080,25153,4.233333333333333,0,1,92246
2025-01-27,NVIDIA RTX 3080,78286,4.1,1784,58498,3.5,1119,66822,5.0,1110,19788,11464,4.2,0,1,78286
2025-01-27,AMD RX 6600,50120,3.9,310,46858,4.5,177,40976,4.9,310,3262,9144,4.433333333333334,0,3,150360
2025-01-27,AMD RX 6700 XT,35180,4.5,727,75363,3.7,775,27673,3.6,121,-40183,7507,3.933333333333333,0,217,7634060
2025-01-27,NVIDIA RTX 4060,85383,4.6,441,77999,3.5,1549,41045,5.0,1864,7384,44338,4.366666666666666,0,1,85383
2025-01-27,AMD RX 7900 XTX,83062,4.2,1588,90230,4.2,1828,80959,3.8,491,-7168,2103,4.066666666666666,0,77,6395774
2025-01-26,NVIDIA RTX 3060,73246,5.0,662,35612,3.8,887,74752,5.0,1509,37634,-1506,4.6000000000000005,0,1,73246
2025-01-26,NVIDIA RTX 3070,30132,4.5,931,86177,4.4,835,31007,4.8,188,-56045,-875,4.566666666666666,1,307,9250524
2025-01-26,NVIDIA RTX 3080,73822,4.7,1491,71289,4.0,213,36916,4.9,253,2533,36906,4.533333333333333,0,1,73822
2025-01-26,AMD RX 6600,43224,3.7,1344,36875,4.3,796,59264,4.5,1721,6349,-16040,4.166666666666667,0,2,86448
2025-01-26,AMD RX 6700 XT,79717,3.7,583,36310,4.6,693,73960,4.5,1994,43407,5757,4.266666666666667,0,1,79717
2025-01-26,NVIDIA RTX 4060,72981,4.1,1261,50069,4.3,886,44835,4.2,358,22912,28146,4.199999999999999,0,1,72981
2025-01-26,AMD RX 7900 XTX,31200,3.7,1021,49483,4.5,1935,65067,4.6,1918,-18283,-33867,4.266666666666667,1,103,3213600
2025-01-25,NVIDIA RTX 3060,73670,4.2,257,41160,4.5,1096,81388,4.2,350,32510,-7718,4.3,0,1,73670
2025-01-25,NVIDIA RTX 3070,44384,4.1,743,38306,4.2,488,94710,3.9,1078,6078,-50326,4.066666666666667,0,1,44384
2025-01-25,NVIDIA RTX 3080,60572,4.9,153,40634,3.8,1574,88536,4.0,1596,19938,-27964,4.233333333333333,0,1,60572
2025-01-25,AMD RX 6600,50473,4.3,1970,57265,4.1,1723,87119,3.6,1669,-6792,-36646,3.9999999999999996,1,66,3331218
2025-01-25,AMD RX 6700 XT,39579,4.7,1541,66427,4.3,1808,66655,3.6,1243,-26848,-27076,4.2,1,184,7282536
2025-01-25,NVIDIA RTX 4060,82250,5.0,684,81025,3.6,214,59170,4.5,1852,1225,23080,4.366666666666666,0,38,3125500
2025-01-25,AMD RX 7900 XTX,88021,3.7,1846,72171,3.6,342,54679,3.6,1112,15850,33342,3.6333333333333333,0,1,88021
2025-01-24,NVIDIA RTX 3060,35409,3.8,1560,55101,4.5,1038,31639,3.5,542,-19692,3770,3.9333333333333336,0,137,4851033
2025-01-24,NVIDIA RTX 3070,81060,4.7,1831,46269,3.8,247,86515,3.8,314,34791,-5455,4.1000000000000005,0,1,81060
2025-01-24,NVIDIA RTX 3080,69359,4.0,232,27992,4.2,139,68332,4.7,1659,41367,1027,4.3,0,1,69359
2025-01-24,AMD RX 6600,62515,4.8,1557,88828,3.6,1536,95369,4.8,1657,-26313,-32854,4.3999999999999995,1,154,9627310
2025-01-24,AMD RX 6700 XT,47779,4.3,348,39226,3.8,202,68675,4.2,415,8553,-20896,4.1000000000000005,0,1,47779
2025-01-24,NVIDIA RTX 4060,49479,3.9,1111,63080,4.2,449,88992,4.9,548,-13601,-39513,4.333333333333333,1,87,4304673
2025-01-24,AMD RX 7900 XTX,28401,4.3,855,31254,3.7,1318,72821,5.0,1877,-2853,-44420,4.333333333333333,1,64,1817664
2025-01-23,NVIDIA RTX 3060,87782,3.7,1910,51426,4.7,972,90963,4.7,484,36356,-3181,4.366666666666667,0,1,87782
2025-01-23,NVIDIA RTX 3070,33838,4.0,1568,71773,4.1,347,33272,4.1,1505,-37935,566,4.066666666666666,0,201,6801438
2025-01-23,NVIDIA RTX 3080,89045,4.1,938,42634,4.8,1724,66986,4.5,401,46411,22059,4.466666666666666,0,1,89045
2025-01-23,AMD RX 6600,32692,5.0,1415,50321,4.4,787,83295,4.6,592,-17629,-50603,4.666666666666667,1,132,4315344
2025-01-23,AMD RX 6700 XT,35406,4.2,1159,31275,3.9,1651,27949,3.8,158,4131,7457,3.9666666666666663,0,14,495684
2025-01-23,NVIDIA RTX 4060,68207,4.8,1697,77791,4.5,1233,89843,4.3,820,-9584,-21636,4.533333333333334,1,88,6002216
2025-01-23,AMD RX 7900 XTX,46907,4.1,1965,47220,3.9,1291,57778,4.9,272,-313,-10871,4.3,1,14,656698
2025-01-22,NVIDIA RTX 3060,30280,4.3,722,28426,3.6,1835,71989,3.8,912,1854,-41709,3.9,0,35,1059800
2025-01-22,NVIDIA RTX 3070,44907,4.0,1552,72592,3.5,1097,91352,4.3,208,-27685,-46445,3.9333333333333336,1,172,7724004
2025-01-22,NVIDIA RTX 3080,54386,4.9,1162,32632,3.5,1996,82080,4.1,200,21754,-27694,4.166666666666667,0,1,54386
2025-01-22,AMD RX 6600,59876,3.9,1400,39472,4.5,1916,78133,4.9,497,20404,-18257,4.433333333333334,0,1,59876
2025-01-22,AMD RX 6700 XT,58997,4.4,1358,62598,4.5,1722,62086,4.1,1316,-3601,-3089,4.333333333333333,1,36,2123892
2025-01-22,NVIDIA RTX 4060,92689,4.3,445,90062,3.7,393,62504,4.4,1162,2627,30185,4.133333333333334,0,24,2224536
2025-01-22,AMD RX 7900 XTX,43612,4.5,1575,61798,4.2,589,79722,4.5,1423,-18186,-36110,4.3999999999999995,1,133,5800396
2025-01-21,NVIDIA RTX 3060,70869,3.6,1869,49879,4.5,1321,55538,3.8,208,20990,15331,3.9666666666666663,0,1,70869
2025-01-21,NVIDIA RTX 3070,26383,3.6,1413,51468,4.2,280,31389,3.9,234,-25085,-5006,3.9000000000000004,1,152,4010216
2025-01-21,NVIDIA RTX 3080,62022,3.8,1271,64327,4.1,1242,92574,3.9,1907,-2305,-30552,3.933333333333333,1,49,3039078
2025-01-21,AMD RX 6600,81665,4.5,1119,54457,3.7,1185,78236,4.1,550,27208,3429,4.1,0,1,81665
2025-01-21,AMD RX 6700 XT,65225,4.9,1089,39611,4.0,1658,61218,3.8,1709,25614,4007,4.233333333333333,0,1,65225
2025-01-21,NVIDIA RTX 4060,59707,4.1,1028,90320,4.2,1382,51530,4.5,1545,-30613,8177,4.266666666666667,0,168,10030776
2025-01-21,AMD RX 7900 XTX,37205,3.6,1000,51541,3.6,330,59770,3.6,1130,-14336,-22565,3.6,1,85,3162425
2025-01-20,NVIDIA RTX 3060,80442,4.2,796,47171,4.8,1966,86990,4.8,1508,33271,-6548,4.6000000000000005,0,1,80442
2025-01-20,NVIDIA RTX 3070,43390,4.8,753,88257,3.8,1472,54670,4.0,242,-44867,-11280,4.2,1,253,10977670
2025-01-20,NVIDIA RTX 3080,70534,3.7,858,28093,4.5,683,45376,4.0,1032,42441,25158,4.066666666666666,0,1,70534
2025-01-20,AMD RX 6600,94100,3.7,595,53031,3.9,1363,40694,4.5,976,41069,53406,4.033333333333333,0,1,94100
2025-01-20,AMD RX 6700 XT,84144,3.9,607,81748,3.7,207,65955,3.8,640,2396,18189,3.7999999999999994,0,24,2019456
2025-01-20,NVIDIA RTX 4060,41258,3.6,886,46347,4.7,1093,33487,4.5,1847,-5089,7771,4.266666666666667,0,67,2764286
2025-01-20,AMD RX 7900 XTX,78838,4.9,1947,90439,3.6,581,28141,4.0,1070,-11601,50697,4.166666666666667,0,86,6780068
2025-01-19,NVIDIA RTX 3060,45614,4.9,1576,85158,4.4,958,26131,4.8,1067,-39544,19483,4.7,0,219,9989466
2025-01-19,NVIDIA RTX 3070,64543,4.6,1120,53594,4.8,571,36707,4.7,1261,10949,27836,4.699999999999999,0,1,64543
2025-01-19,NVIDIA RTX 3080,93290,4.2,731,39106,3.8,585,61967,4.3,442,54184,31323,4.1000000000000005,0,1,93290
2025-01-19,AMD RX 6600,87380,3.6,905,77717,4.1,551,41981,3.6,1746,9663,45399,3.766666666666666,0,1,87380
2025-01-19,AMD RX 6700 XT,91994,5.0,540,35495,4.4,211,69704,4.2,818,56499,22290,4.533333333333334,0,1,91994
2025-01-19,NVIDIA RTX 4060,68652,3.6,1113,80316,3.8,1348,61164,4.2,846,-11664,7488,3.866666666666667,0,104,7139808
2025-01-19,AMD RX 7900 XTX,86020,4.3,1835,83094,4.1,379,82240,4.7,716,2926,3780,4.366666666666666,0,8,688160
2025-01-18,NVIDIA RTX 3060,39619,3.7,641,87892,3.8,834,69985,4.7,1855,-48273,-30366,4.066666666666666,1,263,10419797
2025-01-18,NVIDIA RTX 3070,73246,4.0,920,59005,4.0,165,86408,3.9,1163,14241,-13162,3.966666666666667,0,1,73246
2025-01-18,NVIDIA RTX 3080,33376,4.3,842,32116,3.7,1844,25927,5.0,1853,1260,7449,4.333333333333333,0,39,1301664
2025-01-18,AMD RX 6600,60429,4.1,1022,86774,4.1,1657,56270,5.0,831,-26345,4159,4.3999999999999995,0,166,10031214
2025-01-18,AMD RX 6700 XT,63768,4.5,343,68834,4.8,1336,87504,3.9,1617,-5066,-23736,4.4,1,72,4591296
2025-01-18,NVIDIA RTX 4060,39656,4.1,1727,47776,4.9,1954,81399,3.8,282,-8120,-41743,4.266666666666667,1,68,2696608
2025-01-18,AMD RX 7900 XTX,71013,4.9,1646,49008,5.0,1851,50501,4.5,660,22005,20512,4.8,0,1,71013
2025-01-17,NVIDIA RTX 3060,42539,4.4,922,52815,4.1,1168,85202,3.8,1964,-10276,-42663,4.1000000000000005,1,67,2850113
2025-01-17,NVIDIA RTX 3070,87875,3.6,380,87895,4.4,1814,70436,4.1,954,-20,17439,4.033333333333333,0,21,1845375
2025-01-17,NVIDIA RTX 3080,69532,4.3,405,84941,3.5,976,60741,3.8,1286,-15409,8791,3.8666666666666667,0,126,8761032
2025-01-17,AMD RX 6600,90713,4.0,1355,56359,4.0,1286,95916,4.0,1354,34354,-5203,4.0,0,1,90713
2025-01-17,AMD RX 6700 XT,65081,4.1,1362,55998,4.9,1971,41666,4.7,1260,9083,23415,4.566666666666666,0,1,65081
2025-01-17,NVIDIA RTX 4060,66084,4.0,1796,26087,5.0,182,69843,3.7,117,39997,-3759,4.233333333333333,0,1,66084
2025-01-17,AMD RX 7900 XTX,93169,4.2,1252,87819,3.6,1187,93010,3.7,1494,5350,159,3.8333333333333335,0,1,93169
2025-01-16,NVIDIA RTX 3060,65184,4.7,854,77610,4.7,1526,45975,5.0,1377,-12426,19209,4.8,0,89,5801376
2025-01-16,NVIDIA RTX 3070,70935,3.7,953,38550,4.2,270,45800,4.2,232,32385,25135,4.033333333333334,0,1,70935
2025-01-16,NVIDIA RTX 3080,68268,4.8,1388,29306,4.6,546,60757,4.2,545,38962,7511,4.533333333333332,0,1,68268
2025-01-16,AMD RX 6600,30381,4.2,1442,42330,3.9,1426,63953,3.7,1100,-11949,-33572,3.9333333333333336,1,90,2734290
2025-01-16,AMD RX 6700 XT,57733,3.6,1083,34022,4.2,724,62125,4.1,1452,23711,-4392,3.966666666666667,0,1,57733
2025-01-16,NVIDIA RTX 4060,48643,4.4,1369,48968,4.2,1268,22492,3.9,817,-325,26151,4.166666666666667,0,38,1848434
2025-01-16,AMD RX 7900 XTX,73042,4.7,596,28925,4.2,383,63240,4.5,1674,44117,9802,4.466666666666667,0,1,73042
2025-01-15,NVIDIA RTX 3060,30828,4.9,325,76646,4.7,858,43025,4.6,392,-45818,-12197,4.733333333333333,1,265,8169420
2025-01-15,NVIDIA RTX 3070,47161,4.2,957,88622,4.5,1862,51324,4.4,265,-41461,-4163,4.366666666666666,1,222,10469742
2025-01-15,NVIDIA RTX 3080,45230,4.5,940,34418,4.8,781,61908,3.5,826,10812,-16678,4.266666666666667,0,1,45230
2025-01-15,AMD RX 6600,92783,4.9,1887,91855,3.9,1641,60159,4.5,965,928,32624,4.433333333333334,0,8,742264
2025-01-15,AMD RX 6700 XT,35944,3.7,524,63079,4.9,1210,75115,4.8,1984,-27135,-39171,4.466666666666668,1,153,5499432
2025-01-15,NVIDIA RTX 4060,70028,4.2,871,54759,3.6,1903,66476,4.0,1254,15269,3552,3.9333333333333336,0,1,70028
2025-01-15,AMD RX 7900 XTX,64542,4.2,1191,66449,4.3,1963,84684,4.8,1747,-1907,-20142,4.433333333333334,1,38,2452596
2025-01-14,NVIDIA RTX 3060,71344,4.0,1681,70130,3.7,848,45839,4.7,612,1214,25505,4.133333333333334,0,42,2996448
2025-01-14,NVIDIA RTX 3070,61647,4.2,604,88065,3.6,850,43195,4.3,716,-26418,18452,4.033333333333334,0,176,10849872
2025-01-14,NVIDIA RTX 3080,63140,3.9,709,50281,4.3,237,62677,3.9,1998,12859,463,4.033333333333333,0,1,63140
2025-01-14,AMD RX 6600,65654,3.8,1543,49965,5.0,588,86915,3.8,1702,15689,-21261,4.2,0,1,65654
2025-01-14,AMD RX 6700 XT,88691,4.2,1247,42200,4.2,1640,80050,3.7,1005,46491,8641,4.033333333333334,0,1,88691
2025-01-14,NVIDIA RTX 4060,60199,3.7,1485,51344,4.0,1938,67186,4.9,1559,8855,-6987,4.2,0,1,60199
2025-01-14,AMD RX 7900 XTX,74999,4.7,1683,61168,4.5,667,72701,4.0,1055,13831,2298,4.3999999999999995,0,1,74999
2025-01-13,NVIDIA RTX 3060,43577,3.6,1562,29657,4.1,1026,80476,4.2,1968,13920,-36899,3.9666666666666663,0,1,43577
2025-01-13,NVIDIA RTX 3070,35195,4.9,1443,89837,4.3,351,28911,3.6,387,-54642,6284,4.266666666666667,0,299,10523305
2025-01-13,NVIDIA RTX 3080,59536,3.8,1795,89439,4.3,1790,63621,4.4,864,-29903,-4085,4.166666666666667,1,172,10240192
2025-01-13,AMD RX 6600,62141,4.5,381,94236,4.2,853,43768,4.3,1258,-32095,18373,4.333333333333333,0,202,12552482
2025-01-13,AMD RX 6700 XT,41359,4.6,590,32143,4.8,1037,60887,4.6,904,9216,-19528,4.666666666666666,0,1,41359
2025-01-13,NVIDIA RTX 4060,54194,4.5,1187,34099,4.1,466,41806,4.5,1047,20095,12388,4.366666666666666,0,1,54194
2025-01-13,AMD RX 7900 XTX,56805,3.8,305,60427,3.7,665,93666,4.8,273,-3622,-36861,4.1000000000000005,1,41,2329005
2025-01-12,NVIDIA RTX 3060,78877,4.6,305,42393,3.7,408,31381,4.7,1430,36484,47496,4.333333333333333,0,1,78877
2025-01-12,NVIDIA RTX 3070,40060,4.9,423,53037,4.9,146,38762,4.4,1783,-12977,1298,4.733333333333333,0,89,3565340
2025-01-12,NVIDIA RTX 3080,80682,4.9,1898,63838,5.0,1208,64718,4.2,778,16844,15964,4.7,0,1,80682
2025-01-12,AMD RX 6600,88261,4.5,1648,43187,4.0,1009,30971,4.6,1481,45074,57290,4.366666666666666,0,1,88261
2025-01-12,AMD RX 6700 XT,62280,3.9,221,27203,3.8,145,94827,3.6,519,35077,-32547,3.766666666666666,0,1,62280
2025-01-12,NVIDIA RTX 4060,39068,4.4,1195,56707,4.5,943,90847,4.3,1114,-17639,-51779,4.3999999999999995,1,140,5469520
2025-01-12,AMD RX 7900 XTX,28322,4.1,1815,72301,4.5,768,41709,4.8,1410,-43979,-13387,4.466666666666666,1,265,7505330
2025-01-11,NVIDIA RTX 3060,45337,5.0,913,90580,4.5,1185,44750,4.4,1572,-45243,587,4.633333333333334,0,243,11016891
2025-01-11,NVIDIA RTX 3070,88456,4.9,1886,84111,4.0,370,26817,4.4,511,4345,61639,4.433333333333334,0,1,88456
2025-01-11,NVIDIA RTX 3080,60247,3.5,1263,63578,4.7,564,37585,3.5,1336,-3331,22662,3.9,0,34,2048398
2025-01-11,AMD RX 6600,38808,3.9,1413,88516,5.0,1676,42122,3.6,518,-49708,-3314,4.166666666666667,1,291,11293128
2025-01-11,AMD RX 6700 XT,94769,4.8,374,29417,4.0,1033,39459,3.5,1135,65352,55310,4.1000000000000005,0,1,94769
2025-01-11,NVIDIA RTX 4060,91922,3.9,1756,48872,4.9,1557,83371,3.6,349,43050,8551,4.133333333333334,0,1,91922
2025-01-11,AMD RX 7900 XTX,39472,3.7,1039,60880,5.0,1818,64625,4.2,476,-21408,-25153,4.3,1,147,5802384
2025-01-10,NVIDIA RTX 3060,61606,3.8,1608,43437,3.9,184,57270,3.9,1354,18169,4336,3.8666666666666667,0,1,61606
2025-01-10,NVIDIA RTX 3070,68601,4.4,1650,68206,3.7,633,84948,4.4,985,395,-16347,4.166666666666667,0,14,960414
2025-01-10,NVIDIA RTX 3080,48755,4.4,1408,71964,3.8,1548,46379,3.5,390,-23209,2376,3.9,0,164,7995820
2025-01-10,AMD RX 6600,78651,4.3,277,31998,4.0,804,54944,4.3,1532,46653,23707,4.2,0,1,78651
2025-01-10,AMD RX 6700 XT,80020,3.6,387,44445,4.2,432,52160,4.2,692,35575,27860,4.0,0,1,80020
2025-01-10,NVIDIA RTX 4060,87230,4.9,113,94415,3.7,151,39932,4.2,1467,-7185,47298,4.266666666666667,0,89,7763470
2025-01-10,AMD RX 7900 XTX,59323,3.9,1643,79117,4.7,1038,61272,4.1,1738,-19794,-1949,4.233333333333333,1,135,8008605
2025-01-09,NVIDIA RTX 3060,59695,4.0,1580,65249,3.5,1612,39868,4.1,970,-5554,19827,3.8666666666666667,0,79,4715905
2025-01-09,NVIDIA RTX 3070,25640,4.5,1518,91220,4.5,705,41649,3.9,346,-65580,-16009,4.3,1,363,9307320
2025-01-09,NVIDIA RTX 3080,53480,4.5,1053,86490,5.0,1644,73133,4.4,169,-33010,-19653,4.633333333333334,1,191,10214680
2025-01-09,AMD RX 6600,63521,4.1,1129,45908,4.6,1988,80607,4.9,826,17613,-17086,4.533333333333333,0,1,63521
2025-01-09,AMD RX 6700 XT,68414,3.7,1976,82721,4.5,1598,44091,4.8,1038,-14307,24323,4.333333333333333,0,108,7388712
2025-01-09,NVIDIA RTX 4060,63681,4.4,548,85109,3.7,1228,58368,5.0,832,-21428,5313,4.366666666666667,0,122,7769082
2025-01-09,AMD RX 7900 XTX,43424,3.7,1631,39842,3.5,1364,91741,3.8,1948,3582,-48317,3.6666666666666665,0,19,825056
2025-01-08,NVIDIA RTX 3060,74377,4.6,1969,54536,4.0,768,94019,4.3,457,19841,-19642,4.3,0,1,74377
2025-01-08,NVIDIA RTX 3070,88115,4.7,1790,34194,4.5,1294,44726,4.5,1253,53921,43389,4.566666666666666,0,1,88115
2025-01-08,NVIDIA RTX 3080,52654,4.5,1320,92819,4.7,1671,70235,4.6,1711,-40165,-17581,4.6,1,238,12531652
2025-01-08,AMD RX 6600,37034,4.2,1541,60031,3.5,1202,42635,4.7,1448,-22997,-5601,4.133333333333334,1,127,4703318
2025-01-08,AMD RX 6700 XT,70058,4.9,329,85933,4.5,278,64932,3.6,1818,-15875,5126,4.333333333333333,0,104,7286032
2025-01-08,NVIDIA RTX 4060,34580,4.9,514,92312,3.8,750,88489,4.9,1340,-57732,-53909,4.533333333333333,1,325,11238500
2025-01-08,AMD RX 7900 XTX,42988,4.0,1165,89509,4.9,839,50360,4.6,1138,-46521,-7372,4.5,1,268,11520784
2025-01-07,NVIDIA RTX 3060,80864,4.5,1568,75319,4.6,975,92992,3.7,763,5545,-12128,4.266666666666667,0,12,970368
2025-01-07,NVIDIA RTX 3070,86815,4.8,1012,73611,4.1,682,72413,4.4,926,13204,14402,4.433333333333333,0,1,86815
2025-01-07,NVIDIA RTX 3080,33006,3.7,950,70087,4.0,1012,31224,3.5,1600,-37081,1782,3.733333333333333,0,209,6898254
2025-01-07,AMD RX 6600,86492,3.6,1046,35247,4.6,1009,44761,3.6,317,51245,41731,3.933333333333333,0,1,86492
2025-01-07,AMD RX 6700 XT,68317,3.5,621,80098,3.9,1750,93026,4.2,1656,-11781,-24709,3.866666666666667,1,98,6695066
2025-01-07,NVIDIA RTX 4060,24180,4.4,192,83520,4.8,385,54285,3.7,1903,-59340,-30105,4.3,1,347,8390460
2025-01-07,AMD RX 7900 XTX,80356,4.6,1208,34458,3.8,1072,50771,4.8,1647,45898,29585,4.3999999999999995,0,1,80356
2025-01-06,NVIDIA RTX 3060,30462,5.0,1066,93599,3.6,1309,77584,3.6,612,-63137,-47122,4.066666666666666,1,355,10814010
2025-01-06,NVIDIA RTX 3070,28510,4.1,1674,71977,3.5,1408,37310,4.8,249,-43467,-8800,4.133333333333333,1,268,7640680
2025-01-06,NVIDIA RTX 3080,45005,5.0,1422,61220,3.8,1046,82938,4.4,1821,-16215,-37933,4.4,1,104,4680520
2025-01-06,AMD RX 6600,80164,5.0,883,41579,3.8,881,27286,4.0,1530,38585,52878,4.266666666666667,0,1,80164
2025-01-06,AMD RX 6700 XT,83882,4.1,1498,64477,4.2,1785,84011,3.7,1405,19405,-129,4.0,0,1,83882
2025-01-06,NVIDIA RTX 4060,44784,4.8,342,66376,4.0,1245,49782,3.9,996,-21592,-4998,4.233333333333333,1,154,6896736
2025-01-06,AMD RX 7900 XTX,49793,4.1,360,84584,3.5,105,61345,3.8,431,-34791,-11552,3.7999999999999994,1,203,10107979
2025-01-05,NVIDIA RTX 3060,51216,4.6,711,44339,4.0,1411,83222,4.7,493,6877,-32006,4.433333333333334,0,9,460944
2025-01-05,NVIDIA RTX 3070,88203,4.6,968,84953,4.5,1928,38042,3.5,1469,3250,50161,4.2,0,1,88203
2025-01-05,NVIDIA RTX 3080,94828,4.7,606,63124,3.8,1957,36276,3.5,387,31704,58552,4.0,0,1,94828
2025-01-05,AMD RX 6600,85210,3.7,486,54312,3.7,667,25631,4.7,1263,30898,59579,4.033333333333334,0,1,85210
2025-01-05,AMD RX 6700 XT,37053,4.7,958,87171,4.4,840,34223,3.8,1594,-50118,2830,4.300000000000001,0,264,9781992
2025-01-05,NVIDIA RTX 4060,26021,3.8,306,89611,4.2,628,95290,3.8,524,-63590,-69269,3.9333333333333336,1,354,9211434
2025-01-05,AMD RX 7900 XTX,30057,4.4,1540,90082,4.7,864,88195,4.0,1366,-60025,-58138,4.366666666666667,1,316,9498012
2025-01-04,NVIDIA RTX 3060,30384,4.6,923,93889,3.5,631,40621,4.2,1380,-63505,-10237,4.1000000000000005,1,365,11090160
2025-01-04,NVIDIA RTX 3070,81454,4.3,1644,48108,3.6,754,71878,4.4,360,33346,9576,4.1000000000000005,0,1,81454
2025-01-04,NVIDIA RTX 3080,30545,4.3,692,88108,3.7,434,92239,3.7,1121,-57563,-61694,3.9,1,308,9407860
2025-01-04,AMD RX 6600,58684,4.4,1282,31165,4.0,1403,52642,4.4,777,27519,6042,4.266666666666667,0,1,58684
2025-01-04,AMD RX 6700 XT,65970,4.0,393,69058,3.9,1184,26789,4.7,693,-3088,39181,4.2,0,49,3232530
2025-01-04,NVIDIA RTX 4060,92131,4.1,663,36278,3.8,1386,58147,4.6,239,55853,33984,4.166666666666667,0,1,92131
2025-01-04,AMD RX 7900 XTX,34549,4.9,1901,46792,4.4,442,45050,3.6,1278,-12243,-10501,4.3,1,99,3420351
2025-01-03,NVIDIA RTX 3060,50083,4.5,1238,66874,4.7,1502,57881,4.9,1124,-16791,-7798,4.7,1,113,5659379
2025-01-03,NVIDIA RTX 3070,87346,5.0,1417,63685,4.5,1509,66195,4.4,1218,23661,21151,4.633333333333334,0,1,87346
2025-01-03,NVIDIA RTX 3080,76254,4.0,952,70301,4.3,820,41306,4.2,1978,5953,34948,4.166666666666667,0,2,152508
2025-01-03,AMD RX 6600,76733,3.9,476,40942,3.7,676,61829,3.5,792,35791,14904,3.6999999999999997,0,1,76733
2025-01-03,AMD RX 6700 XT,86039,4.8,715,74863,4.1,1986,79371,3.8,1918,11176,6668,4.233333333333333,0,1,86039
2025-01-03,NVIDIA RTX 4060,44713,4.9,1251,44207,3.8,1130,30925,3.8,1772,506,13788,4.166666666666667,0,48,2146224
2025-01-03,AMD RX 7900 XTX,79502,4.3,374,52524,4.7,1244,70636,4.9,227,26978,8866,4.633333333333334,0,1,79502
2025-01-02,NVIDIA RTX 3060,74899,3.9,776,95256,4.6,1538,56925,3.6,1254,-20357,17974,4.033333333333333,0,131,9811769
2025-01-02,NVIDIA RTX 3070,36047,4.8,289,40355,4.2,256,29467,5.0,952,-4308,6580,4.666666666666667,0,64,2307008
2025-01-02,NVIDIA RTX 3080,47388,3.9,1479,38353,4.9,1082,37080,4.2,365,9035,10308,4.333333333333333,0,1,47388
2025-01-02,AMD RX 6600,27779,3.8,1659,70192,4.5,384,63381,3.6,172,-42413,-35602,3.966666666666667,1,253,7028087
2025-01-02,AMD RX 6700 XT,54371,3.8,1957,84820,4.3,800,91247,3.8,817,-30449,-36876,3.9666666666666663,1,186,10113006
2025-01-02,NVIDIA RTX 4060,68125,4.9,131,50386,4.0,1624,82471,4.0,1840,17739,-14346,4.3,0,1,68125
2025-01-02,AMD RX 7900 XTX,51318,4.9,340,39365,3.7,1521,52027,4.9,153,11953,-709,4.500000000000001,0,1,51318
2025-01-01,NVIDIA RTX 3060,86760,4.5,1541,46295,3.8,356,52088,4.4,876,40465,34672,4.233333333333333,0,1,86760
2025-01-01,NVIDIA RTX 3070,52054,4.9,1230,50570,5.0,970,28897,4.2,892,1484,23157,4.7,0,44,2290376
2025-01-01,NVIDIA RTX 3080,66472,4.1,1192,37279,3.5,1091,77141,3.7,1536,29193,-10669,3.766666666666667,0,1,66472
2025-01-01,AMD RX 6600,71614,3.9,1150,78872,3.8,167,82446,3.7,996,-7258,-10832,3.7999999999999994,1,55,3938770
2025-01-01,AMD RX 6700 XT,90996,3.6,1579,94161,3.6,343,42508,5.0,853,-3165,48488,4.066666666666666,0,56,5095776
2025-01-01,NVIDIA RTX 4060,86160,4.9,859,55516,3.6,1467,69695,4.0,1980,30644,16465,4.166666666666667,0,1,86160
2025-01-01,AMD RX 7900 XTX,66405,3.6,1869,24136,4.7,1984,31543,3.8,1305,42269,34862,4.033333333333334,0,1,66405
2024-12-31,NVIDIA RTX 3060,52197,3.5,1233,53735,4.9,478,25177,4.1,1641,-1538,27020,4.166666666666667,0,48,2505456
2024-12-31,NVIDIA RTX 3070,79150,3.7,775,68315,3.6,1832,28122,4.8,611,10835,51028,4.033333333333334,0,1,79150
2024-12-31,NVIDIA RTX 3080,55260,4.4,603,63105,4.0,428,30082,3.6,998,-7845,25178,4.0,0,85,4697100
2024-12-31,AMD RX 6600,91954,4.5,1502,93587,4.4,1134,47985,3.6,816,-1633,43969,4.166666666666667,0,53,4873562
2024-12-31,AMD RX 6700 XT,68353,4.6,1100,31768,4.7,1663,56408,3.7,914,36585,11945,4.333333333333333,0,1,68353
2024-12-31,NVIDIA RTX 4060,90078,3.8,1728,28164,3.8,492,90130,3.7,257,61914,-52,3.766666666666667,0,1,90078
2024-12-31,AMD RX 7900 XTX,69546,3.7,1219,60350,4.9,1200,34060,4.9,521,9196,35486,4.500000000000001,0,1,69546
2024-12-30,NVIDIA RTX 3060,87511,4.9,1210,28509,3.6,538,92648,4.6,831,59002,-5137,4.366666666666666,0,1,87511
2024-12-30,NVIDIA RTX 3070,33990,3.6,1834,93882,4.2,1529,54506,4.6,851,-59892,-20516,4.133333333333334,1,349,11862510
2024-12-30,NVIDIA RTX 3080,37216,3.6,113,49865,4.5,319,65716,3.9,1928,-12649,-28500,4.0,1,90,3349440
2024-12-30,AMD RX 6600,77179,4.8,573,48610,5.0,968,59678,4.5,1131,28569,17501,4.766666666666667,0,1,77179
2024-12-30,AMD RX 6700 XT,36701,3.7,547,54297,3.8,331,36123,4.0,941,-17596,578,3.8333333333333335,0,116,4257316
2024-12-30,NVIDIA RTX 4060,92022,4.1,1365,64205,4.2,1164,88019,3.6,1967,27817,4003,3.966666666666667,0,1,92022
2024-12-30,AMD RX 7900 XTX,90734,4.2,113,43875,4.6,1543,44241,3.8,1619,46859,46493,4.2,0,1,90734
2024-12-29,NVIDIA RTX 3060,96277,4.1,134,64348,4.6,268,50630,4.1,1771,31929,45647,4.266666666666667,0,1,96277
2024-12-29,NVIDIA RTX 3070,97307,3.9,687,69050,3.7,680,40900,5.0,1530,28257,56407,4.2,0,1,97307
2024-12-29,NVIDIA RTX 3080,28360,4.7,1480,86810,4.6,1507,85032,4.6,333,-58450,-56672,4.633333333333334,1,325,9217000
2024-12-29,AMD RX 6600,79904,3.7,297,82040,4.3,695,28877,4.8,653,-2136,51027,4.266666666666667,0,36,2876544
2024-12-29,AMD RX 6700 XT,91951,3.9,1369,79639,4.8,1932,63251,4.1,1794,12312,28700,4.266666666666667,0,1,91951
2024-12-29,NVIDIA RTX 4060,93070,4.7,647,89910,4.1,126,33563,3.9,1348,3160,59507,4.233333333333333,0,9,837630
2024-12-29,AMD RX 7900 XTX,74669,4.1,931,91946,3.7,997,76380,3.5,883,-17277,-1711,3.766666666666667,1,119,8885611
2024-12-28,NVIDIA RTX 3060,86789,3.9,1527,95900,4.5,344,76055,3.6,521,-9111,10734,4.0,0,75,6509175
2024-12-28,NVIDIA RTX 3070,54060,4.5,1836,44025,4.1,1309,73229,4.5,1190,10035,-19169,4.366666666666666,0,1,54060
2024-12-28,NVIDIA RTX 3080,37921,5.0,1430,36714,3.6,507,34259,4.0,1209,1207,3662,4.2,0,28,1061788
2024-12-28,AMD RX 6600,26917,4.1,872,68025,4.4,927,67799,4.9,1645,-41108,-40882,4.466666666666667,1,250,6729250
2024-12-28,AMD RX 6700 XT,84849,4.5,1539,39997,4.8,1585,68218,4.7,1310,44852,16631,4.666666666666667,0,1,84849
2024-12-28,NVIDIA RTX 4060,45140,4.2,988,89700,4.6,1668,50606,4.0,1798,-44560,-5466,4.266666666666667,1,251,11330140
2024-12-28,AMD RX 7900 XTX,70055,5.0,295,63053,4.9,829,82397,4.7,1606,7002,-12342,4.866666666666667,0,1,70055
2024-12-27,NVIDIA RTX 3060,91574,3.8,1945,89828,4.4,928,30380,4.3,1577,1746,61194,4.166666666666667,0,40,3662960
2024-12-27,NVIDIA RTX 3070,86544,3.6,252,89697,3.9,1672,64052,4.2,1272,-3153,22492,3.9,0,53,4586832
2024-12-27,NVIDIA RTX 3080,63197,4.3,167,82474,3.7,1102,92144,3.7,880,-19277,-28947,3.9,1,120,7583640
2024-12-27,AMD RX 6600,48084,3.5,524,89068,4.4,375,85205,3.7,131,-40984,-37121,3.866666666666667,1,253,12165252
2024-12-27,AMD RX 6700 XT,46737,4.7,257,26710,4.6,1800,64382,4.9,275,20027,-17645,4.733333333333333,0,1,46737
2024-12-27,NVIDIA RTX 4060,62556,4.3,1260,35022,4.5,466,59205,3.9,1269,27534,3351,4.233333333333333,0,1,62556
2024-12-27,AMD RX 7900 XTX,78553,4.8,779,77104,4.5,412,74037,4.4,840,1449,4516,4.566666666666667,0,18,1413954
2024-12-26,NVIDIA RTX 3060,73457,4.7,1511,66777,4.4,1656,62625,3.9,1437,6680,10832,4.333333333333334,0,2,146914
2024-12-26,NVIDIA RTX 3070,36381,4.6,808,37444,4.6,1671,24635,4.0,1453,-1063,11746,4.3999999999999995,0,52,1891812
2024-12-26,NVIDIA RTX 3080,29838,4.2,1817,90329,3.8,1455,66238,4.8,1008,-60491,-36400,4.266666666666667,1,349,10413462
2024-12-26,AMD RX 6600,34753,4.4,1357,91276,4.3,1210,82791,4.2,1055,-56523,-48038,4.3,1,314,10912442
2024-12-26,AMD RX 6700 XT,76669,3.5,659,71466,4.3,1664,29788,4.2,1829,5203,46881,4.0,0,1,76669
2024-12-26,NVIDIA RTX 4060,85073,3.8,1232,29666,4.8,343,53900,3.6,262,55407,31173,4.066666666666666,0,1,85073
2024-12-26,AMD RX 7900 XTX,74744,3.8,1299,75970,4.0,870,63233,4.3,231,-1226,11511,4.033333333333333,0,53,3961432
2024-12-25,NVIDIA RTX 3060,72518,4.7,704,83771,3.6,462,81201,3.9,1711,-11253,-8683,4.066666666666667,1,102,7396836
2024-12-25,NVIDIA RTX 3070,60143,3.6,648,67504,3.7,982,60320,4.8,360,-7361,-177,4.033333333333334,1,58,3488294
2024-12-25,NVIDIA RTX 3080,45326,4.6,1398,42186,4.6,1098,56971,3.8,1884,3140,-11645,4.333333333333333,0,4,181304
2024-12-25,AMD RX 6600,45412,4.0,318,40996,4.5,1451,30404,3.7,178,4416,15008,4.066666666666666,0,7,317884
2024-12-25,AMD RX 6700 XT,34037,4.9,1010,87478,4.3,420,51756,4.3,1001,-53441,-17719,4.5,1,320,10891840
2024-12-25,NVIDIA RTX 4060,71384,3.7,278,88868,4.1,1113,63936,4.3,566,-17484,7448,4.033333333333333,0,112,7995008
2024-12-25,AMD RX 7900 XTX,50091,4.2,1236,76571,4.5,1669,35823,5.0,627,-26480,14268,4.566666666666666,0,157,7864287
2024-12-24,NVIDIA RTX 3060,92508,3.7,283,61906,3.6,1309,29669,4.8,1839,30602,62839,4.033333333333334,0,1,92508
2024-12-24,NVIDIA RTX 3070,72928,3.6,1324,28963,4.8,814,72739,4.6,1329,43965,189,4.333333333333333,0,1,72928
2024-12-24,NVIDIA RTX 3080,67678,3.5,947,30646,4.0,299,55626,3.7,1138,37032,12052,3.733333333333333,0,1,67678
2024-12-24,AMD RX 6600,73522,4.6,1245,80945,5.0,943,81098,4.3,585,-7423,-7576,4.633333333333333,1,60,4411320
2024-12-24,AMD RX 6700 XT,58501,4.3,1503,68503,4.5,607,51412,4.4,1798,-10002,7089,4.4,0,93,5440593
2024-12-24,NVIDIA RTX 4060,73291,3.7,716,58061,4.0,273,77105,4.5,1893,15230,-3814,4.066666666666666,0,1,73291
2024-12-24,AMD RX 7900 XTX,61219,3.7,442,33082,3.7,447,60276,3.5,1343,28137,943,3.6333333333333333,0,1,61219
2024-12-23,NVIDIA RTX 3060,81233,4.1,1091,28993,4.0,1043,71967,5.0,1937,52240,9266,4.366666666666666,0,1,81233
2024-12-23,NVIDIA RTX 3070,35040,3.9,605,82027,4.3,962,74969,4.9,702,-46987,-39929,4.366666666666666,1,275,9636000
2024-12-23,NVIDIA RTX 3080,91849,4.4,1037,57113,4.5,1304,27396,4.1,695,34736,64453,4.333333333333333,0,1,91849
2024-12-23,AMD RX 6600,37130,4.0,910,27506,4.1,899,46512,3.5,1347,9624,-9382,3.8666666666666667,0,1,37130
2024-12-23,AMD RX 6700 XT,70624,4.1,1865,68950,3.6,1100,52283,4.3,1699,1674,18341,4.0,0,32,2259968
2024-12-23,NVIDIA RTX 4060,68799,4.0,1770,40773,4.5,788,93371,4.6,540,28026,-24572,4.366666666666666,0,1,68799
2024-12-23,AMD RX 7900 XTX,42303,4.0,1523,91225,4.7,1466,76428,3.5,1587,-48922,-34125,4.066666666666666,1,276,11675628
2024-12-22,NVIDIA RTX 3060,52250,4.0,915,67869,4.4,844,44791,4.6,1429,-15619,7459,4.333333333333333,0,98,5120500
2024-12-22,NVIDIA RTX 3070,66217,4.6,1396,80798,4.2,1835,32914,4.9,559,-14581,33303,4.566666666666667,0,101,6687917
2024-12-22,NVIDIA RTX 3080,91074,4.7,767,36261,3.8,643,92699,4.4,1603,54813,-1625,4.3,0,1,91074
2024-12-22,AMD RX 6600,73586,4.7,904,30665,5.0,923,81213,4.6,1835,42921,-7627,4.766666666666667,0,1,73586
2024-12-22,AMD RX 6700 XT,70775,4.9,509,56723,4.6,288,91595,4.4,1450,14052,-20820,4.633333333333334,0,1,70775
2024-12-22,NVIDIA RTX 4060,51167,4.7,155,39264,4.0,237,95002,4.2,651,11903,-43835,4.3,0,1,51167
2024-12-22,AMD RX 7900 XTX,88307,3.8,1733,95500,4.1,811,52274,3.9,599,-7193,36033,3.933333333333333,0,70,6181490
2024-12-21,NVIDIA RTX 3060,65860,3.6,1836,37385,4.7,1133,67072,4.7,841,28475,-1212,4.333333333333333,0,1,65860
2024-12-21,NVIDIA RTX 3070,81140,4.2,1397,64855,4.5,741,55997,4.0,336,16285,25143,4.233333333333333,0,1,81140
2024-12-21,NVIDIA RTX 3080,63674,3.9,415,51618,4.1,1379,57239,4.6,1902,12056,6435,4.2,0,1,63674
2024-12-21,AMD RX 6600,80548,3.6,1324,93262,4.5,1221,78693,3.6,1247,-12714,1855,3.9,0,77,6202196
2024-12-21,AMD RX 6700 XT,89583,4.1,1137,45823,4.4,1157,88901,4.9,1438,43760,682,4.466666666666667,0,1,89583
2024-12-21,NVIDIA RTX 4060,81280,3.6,836,51175,4.2,1453,90416,3.8,1710,30105,-9136,3.866666666666667,0,1,81280
2024-12-21,AMD RX 7900 XTX,34033,4.7,1446,85443,4.9,1191,78781,4.4,1793,-51410,-44748,4.666666666666667,1,301,10243933
2024-12-20,NVIDIA RTX 3060,69893,4.5,190,83486,4.6,222,42824,3.9,1962,-13593,27069,4.333333333333333,0,109,7618337
2024-12-20,NVIDIA RTX 3070,77094,4.9,981,92097,4.0,402,80949,4.4,382,-15003,-3855,4.433333333333334,1,123,9482562
2024-12-20,NVIDIA RTX 3080,35972,3.6,554,54738,4.6,1667,58465,4.0,341,-18766,-22493,4.066666666666666,1,141,5072052
2024-12-20,AMD RX 6600,93184,4.3,1508,64923,4.1,1861,36029,4.1,403,28261,57155,4.166666666666666,0,1,93184
2024-12-20,AMD RX 6700 XT,54622,4.1,1048,35637,3.8,944,91957,4.8,505,18985,-37335,4.233333333333333,0,1,54622
2024-12-20,NVIDIA RTX 4060,88831,4.0,150,59338,4.5,625,49300,3.5,347,29493,39531,4.0,0,1,88831
2024-12-20,AMD RX 7900 XTX,86133,3.9,1985,56274,3.9,407,79027,4.6,1556,29859,7106,4.133333333333333,0,1,86133
2024-12-19,NVIDIA RTX 3060,34203,4.7,1595,47380,3.9,1794,84412,3.7,169,-13177,-50209,4.1000000000000005,1,90,3078270
2024-12-19,NVIDIA RTX 3070,43422,4.0,1032,66505,4.2,993,78743,4.5,249,-23083,-35321,4.233333333333333,1,143,6209346
2024-12-19,NVIDIA RTX 3080,53382,4.2,1075,82613,4.9,513,43569,4.8,1981,-29231,9813,4.633333333333334,0,160,8541120
2024-12-19,AMD RX 6600,38384,4.6,1026,45121,3.7,629,76329,4.0,923,-6737,-37945,4.1000000000000005,1,73,2802032
2024-12-19,AMD RX 6700 XT,64350,4.0,1759,63803,4.3,1419,59477,3.9,789,547,4873,4.066666666666667,0,48,3088800
2024-12-19,NVIDIA RTX 4060,37269,4.8,1427,33453,4.2,140,70969,4.4,320,3816,-33700,4.466666666666667,0,25,931725
2024-12-19,AMD RX 7900 XTX,41881,4.7,1616,29938,4.0,710,28533,4.6,826,11943,13348,4.433333333333333,0,1,41881
2024-12-18,NVIDIA RTX 3060,58197,3.8,427,33667,4.8,1475,84186,4.4,1616,24530,-25989,4.333333333333333,0,1,58197
2024-12-18,NVIDIA RTX 3070,69969,4.1,1046,37087,4.9,1583,81475,4.6,1533,32882,-11506,4.533333333333333,0,1,69969
2024-12-18,NVIDIA RTX 3080,55707,4.4,481,42356,3.7,1604,41145,4.6,1307,13351,14562,4.233333333333333,0,1,55707
2024-12-18,AMD RX 6600,81880,3.5,1357,88556,4.3,1797,89450,3.7,115,-6676,-7570,3.8333333333333335,1,67,5485960
2024-12-18,AMD RX 6700 XT,51545,4.4,896,92908,4.2,284,76000,4.5,876,-41363,-24455,4.366666666666667,1,239,12319255
2024-12-18,NVIDIA RTX 4060,28356,3.8,670,58118,3.7,1752,67592,3.8,1579,-29762,-39236,3.766666666666667,1,166,4707096
2024-12-18,AMD RX 7900 XTX,34929,3.7,1885,65776,4.7,1609,59401,3.8,1110,-30847,-24472,4.066666666666666,1,172,6007788
2024-12-17,NVIDIA RTX 3060,49501,4.0,1037,75043,4.9,546,67105,4.3,1937,-25542,-17604,4.3999999999999995,1,149,7375649
2024-12-17,NVIDIA RTX 3070,39085,4.5,1102,41785,3.8,662,95587,4.3,2000,-2700,-56502,4.2,1,33,1289805
2024-12-17,NVIDIA RTX 3080,96403,4.0,895,82947,3.9,1307,80263,4.0,752,13456,16140,3.966666666666667,0,1,96403
2024-12-17,AMD RX 6600,78259,3.7,820,33347,4.3,1532,46558,3.6,1604,44912,31701,3.8666666666666667,0,1,78259
2024-12-17,AMD RX 6700 XT,87069,3.8,1479,39398,4.3,1072,53140,4.3,1277,47671,33929,4.133333333333333,0,1,87069
2024-12-17,NVIDIA RTX 4060,66019,4.4,1476,56564,4.8,396,64018,4.0,439,9455,2001,4.3999999999999995,0,1,66019
2024-12-17,AMD RX 7900 XTX,42121,3.7,725,73471,4.6,1782,39896,3.9,998,-31350,2225,4.066666666666667,0,184,7750264
2024-12-16,NVIDIA RTX 3060,38827,4.1,389,62564,4.5,1953,52699,3.9,1979,-23737,-13872,4.166666666666667,1,136,5280472
2024-12-16,NVIDIA RTX 3070,92136,4.1,382,31986,4.7,211,60968,4.6,1993,60150,31168,4.466666666666667,0,1,92136
2024-12-16,NVIDIA RTX 3080,75758,3.8,1401,55486,4.3,733,57825,3.9,296,20272,17933,4.0,0,1,75758
2024-12-16,AMD RX 6600,49251,3.8,691,75173,3.7,1875,53634,4.8,1645,-25922,-4383,4.1000000000000005,1,157,7732407
2024-12-16,AMD RX 6700 XT,41920,4.0,1023,56607,4.1,1963,44355,4.4,181,-14687,-2435,4.166666666666667,1,92,3856640
2024-12-16,NVIDIA RTX 4060,31967,4.9,1092,75601,4.0,1784,47630,4.2,1784,-43634,-15663,4.366666666666667,1,237,7576179
2024-12-16,AMD RX 7900 XTX,41493,4.7,1250,55298,3.8,1923,28405,3.8,1269,-13805,13088,4.1000000000000005,0,109,4522737
2024-12-15,NVIDIA RTX 3060,93597,4.2,1502,46596,4.4,1901,83899,4.2,358,47001,9698,4.266666666666667,0,1,93597
2024-12-15,NVIDIA RTX 3070,89855,4.6,1009,75530,3.9,264,83902,4.9,1566,14325,5953,4.466666666666667,0,1,89855
2024-12-15,NVIDIA RTX 3080,87424,3.6,163,90306,4.6,1997,41360,4.8,1110,-2882,46064,4.333333333333333,0,60,5245440
2024-12-15,AMD RX 6600,53297,3.5,560,71486,4.1,1981,57190,4.8,670,-18189,-3893,4.133333333333333,1,103,5489591
2024-12-15,AMD RX 6700 XT,61213,4.7,1258,36472,4.5,1136,40161,4.7,1624,24741,21052,4.633333333333333,0,1,61213
2024-12-15,NVIDIA RTX 4060,91424,4.3,1272,33580,4.1,1593,57113,3.6,420,57844,34311,3.9999999999999996,0,1,91424
2024-12-15,AMD RX 7900 XTX,39163,4.7,1786,68543,4.5,1660,91208,3.9,1391,-29380,-52045,4.366666666666666,1,180,7049340
2024-12-14,NVIDIA RTX 3060,74525,4.7,185,34082,4.5,1390,94724,4.7,1547,40443,-20199,4.633333333333333,0,1,74525
2024-12-14,NVIDIA RTX 3070,84325,3.8,970,85368,3.7,920,63576,4.2,1544,-1043,20749,3.9,0,32,2698400
2024-12-14,NVIDIA RTX 3080,40777,4.6,709,53371,4.0,1279,92928,3.8,1243,-12594,-52151,4.133333333333333,1,93,3792261
2024-12-14,AMD RX 6600,29908,3.9,1865,33685,3.7,1157,31867,4.4,603,-3777,-1959,4.0,1,56,1674848
2024-12-14,AMD RX 6700 XT,36997,4.8,340,43917,4.5,1723,44743,4.1,550,-6920,-7746,4.466666666666667,1,62,2293814
2024-12-14,NVIDIA RTX 4060,54775,4.7,1304,67562,4.2,1605,49820,4.2,1092,-12787,4955,4.366666666666667,0,90,4929750
2024-12-14,AMD RX 7900 XTX,73779,4.4,976,41634,3.8,1314,50593,3.9,506,32145,23186,4.033333333333333,0,1,73779
2024-12-13,NVIDIA RTX 3060,48802,3.7,523,67244,3.8,948,37856,4.8,1634,-18442,10946,4.1000000000000005,0,141,6881082
2024-12-13,NVIDIA RTX 3070,49610,4.4,1190,71672,4.1,872,50100,4.2,1104,-22062,-490,4.233333333333333,1,160,7937600
2024-12-13,NVIDIA RTX 3080,63731,4.3,762,51592,4.9,1990,55150,3.8,956,12139,8581,4.333333333333333,0,1,63731
2024-12-13,AMD RX 6600,62726,4.4,1857,52705,5.0,506,61505,4.1,1295,10021,1221,4.5,0,1,62726
2024-12-13,AMD RX 6700 XT,94989,4.7,377,62056,4.8,201,57988,4.0,1186,32933,37001,4.5,0,1,94989
2024-12-13,NVIDIA RTX 4060,76433,5.0,1875,79626,4.1,632,48059,4.8,1892,-3193,28374,4.633333333333333,0,51,3898083
2024-12-13,AMD RX 7900 XTX,44377,4.8,611,42291,4.9,448,65760,4.2,1731,2086,-21383,4.633333333333333,0,17,754409
2024-12-12,NVIDIA RTX 3060,46995,4.0,606,37496,4.6,991,78304,4.0,1085,9499,-31309,4.2,0,1,46995
2024-12-12,NVIDIA RTX 3070,77481,3.7,1395,86986,4.2,559,61510,3.8,1904,-9505,15971,3.9,0,59,4571379
2024-12-12,NVIDIA RTX 3080,62364,4.1,1025,50186,4.9,1765,63090,5.0,766,12178,-726,4.666666666666667,0,1,62364
2024-12-12,AMD RX 6600,37088,4.7,1674,59249,4.6,882,59852,4.1,460,-22161,-22764,4.466666666666667,1,160,5934080
2024-12-12,AMD RX 6700 XT,37502,4.3,669,42598,4.8,1328,85525,4.5,811,-5096,-48023,4.533333333333333,1,57,2137614
2024-12-12,NVIDIA RTX 4060,74098,4.9,770,52572,4.6,487,79951,3.7,1906,21526,-5853,4.3999999999999995,0,1,74098
2024-12-12,AMD RX 7900 XTX,23087,4.6,1038,78308,4.1,398,89411,4.4,1507,-55221,-66324,4.366666666666666,1,298,6879926
2024-12-11,NVIDIA RTX 3060,69470,4.7,914,28148,5.0,582,53020,3.9,1139,41322,16450,4.533333333333333,0,1,69470
2024-12-11,NVIDIA RTX 3070,54070,4.7,1113,83144,4.1,1501,53544,3.6,1680,-29074,526,4.133333333333334,0,171,9245970
2024-12-11,NVIDIA RTX 3080,59841,4.7,791,82754,3.5,372,66504,4.5,942,-22913,-6663,4.233333333333333,1,161,9634401
2024-12-11,AMD RX 6600,43754,4.8,1714,70045,4.1,534,76918,4.1,633,-26291,-33164,4.333333333333333,1,183,8006982
2024-12-11,AMD RX 6700 XT,72645,4.6,194,78068,4.1,1323,31358,4.2,548,-5423,41287,4.3,0,40,2905800
2024-12-11,NVIDIA RTX 4060,40180,4.7,1041,56182,3.6,220,71755,4.7,731,-16002,-31575,4.333333333333333,1,103,4138540
2024-12-11,AMD RX 7900 XTX,25151,4.9,423,31556,4.9,1064,84029,3.8,1893,-6405,-58878,4.533333333333334,1,50,1257550
2024-12-10,NVIDIA RTX 3060,83579,3.5,976,73406,4.9,1743,48219,3.8,1380,10173,35360,4.066666666666666,0,1,83579
2024-12-10,NVIDIA RTX 3070,54158,4.9,1906,28008,3.9,1369,41483,4.4,364,26150,12675,4.4,0,1,54158
2024-12-10,NVIDIA RTX 3080,62868,4.8,1895,74408,5.0,1474,30526,3.5,876,-11540,32342,4.433333333333334,0,87,5469516
2024-12-10,AMD RX 6600,58680,4.5,612,71697,5.0,1245,39602,4.0,822,-13017,19078,4.5,0,108,6337440
2024-12-10,AMD RX 6700 XT,35849,4.5,1428,32145,3.8,447,35683,3.6,531,3704,166,3.966666666666667,0,1,35849
2024-12-10,NVIDIA RTX 4060,44119,4.1,725,92064,4.9,1897,73846,3.8,421,-47945,-29727,4.266666666666667,1,257,11338583
2024-12-10,AMD RX 7900 XTX,56205,4.5,1541,84432,3.6,1554,79722,3.8,1741,-28227,-23517,3.9666666666666663,1,168,9442440
2024-12-09,NVIDIA RTX 3060,34483,3.8,259,95069,3.7,339,46217,4.0,541,-60586,-11734,3.8333333333333335,1,339,11689737
2024-12-09,NVIDIA RTX 3070,44256,3.8,1492,63421,5.0,1122,54709,3.6,141,-19165,-10453,4.133333333333334,1,120,5310720
2024-12-09,NVIDIA RTX 3080,80411,3.5,803,61784,4.9,679,91855,4.3,1720,18627,-11444,4.233333333333333,0,1,80411
2024-12-09,AMD RX 6600,41265,4.5,1078,61521,4.7,1997,85902,3.7,717,-20256,-44637,4.3,1,142,5859630
2024-12-09,AMD RX 6700 XT,33158,4.1,1596,60806,4.0,1928,27061,4.4,1509,-27648,6097,4.166666666666667,0,188,6233704
2024-12-09,NVIDIA RTX 4060,36270,4.0,1904,46208,4.6,1106,54691,3.9,353,-9938,-18421,4.166666666666667,1,70,2538900
2024-12-09,AMD RX 7900 XTX,62346,4.1,1765,46378,4.8,1446,76894,4.1,1775,15968,-14548,4.333333333333333,0,1,62346
2024-12-08,NVIDIA RTX 3060,44706,5.0,392,80105,3.8,211,58084,3.6,1133,-35399,-13378,4.133333333333334,1,204,9120024
2024-12-08,NVIDIA RTX 3070,35311,4.3,1349,53628,3.6,632,76609,3.5,1800,-18317,-41298,3.8000000000000003,1,120,4237320
2024-12-08,NVIDIA RTX 3080,47116,4.0,536,49220,4.2,337,42684,4.6,1723,-2104,4432,4.266666666666667,0,27,1272132
2024-12-08,AMD RX 6600,45212,4.4,1006,87202,4.2,1552,74856,4.7,1859,-41990,-29644,4.433333333333334,1,222,10037064
2024-12-08,AMD RX 6700 XT,51184,4.8,386,89345,4.2,1832,65570,4.1,1622,-38161,-14386,4.366666666666666,1,219,11209296
2024-12-08,NVIDIA RTX 4060,42971,4.6,819,42417,4.0,517,27546,3.9,515,554,15425,4.166666666666667,0,28,1203188
2024-12-08,AMD RX 7900 XTX,80856,4.7,607,60718,4.8,1635,37229,5.0,1280,20138,43627,4.833333333333333,0,1,80856
2024-12-07,NVIDIA RTX 3060,63582,3.6,1233,90915,4.3,1458,86871,3.9,290,-27333,-23289,3.9333333333333336,1,183,11635506
2024-12-07,NVIDIA RTX 3070,65001,3.5,1834,54619,5.0,108,54459,4.3,1089,10382,10542,4.266666666666667,0,1,65001
2024-12-07,NVIDIA RTX 3080,63220,4.3,1143,95620,3.8,1985,65036,4.3,600,-32400,-1816,4.133333333333333,1,198,12517560
2024-12-07,AMD RX 6600,49935,3.9,211,34086,4.7,1486,72264,5.0,1590,15849,-22329,4.533333333333333,0,1,49935
2024-12-07,AMD RX 6700 XT,57424,4.1,593,37052,3.5,1495,76648,4.6,1563,20372,-19224,4.066666666666666,0,1,57424
2024-12-07,NVIDIA RTX 4060,92708,4.4,1181,41218,4.1,317,39899,3.8,150,51490,52809,4.1000000000000005,0,1,92708
2024-12-07,AMD RX 7900 XTX,26539,4.9,370,65665,3.5,1042,75982,4.2,1076,-39126,-49443,4.2,1,215,5705885
2024-12-06,NVIDIA RTX 3060,77359,4.1,1218,88614,4.4,651,41545,4.0,394,-11255,35814,4.166666666666667,0,72,5569848
2024-12-06,NVIDIA RTX 3070,48503,4.9,1677,25458,5.0,1443,33743,4.3,525,23045,14760,4.733333333333333,0,1,48503
2024-12-06,NVIDIA RTX 3080,31703,4.4,128,84049,4.9,1603,91061,3.9,389,-52346,-59358,4.4,1,301,9542603
2024-12-06,AMD RX 6600,58132,3.6,223,40681,4.8,1741,79897,4.8,1171,17451,-21765,4.3999999999999995,0,1,58132
2024-12-06,AMD RX 6700 XT,78313,3.9,1559,61734,4.7,1623,52947,4.7,616,16579,25366,4.433333333333334,0,1,78313
2024-12-06,NVIDIA RTX 4060,91076,4.1,923,35751,4.9,881,78534,4.6,1808,55325,12542,4.533333333333333,0,1,91076
2024-12-06,AMD RX 7900 XTX,38050,4.3,1361,37397,3.9,591,42040,4.0,1257,653,-3990,4.066666666666666,0,47,1788350
2024-12-05,NVIDIA RTX 3060,44285,3.6,261,75016,3.5,526,75330,3.9,528,-30731,-31045,3.6666666666666665,1,187,8281295
2024-12-05,NVIDIA RTX 3070,90681,5.0,418,46538,4.7,683,90527,4.2,1435,44143,154,4.633333333333333,0,1,90681
2024-12-05,NVIDIA RTX 3080,68027,4.4,1663,43189,3.9,1740,55534,4.2,1089,24838,12493,4.166666666666667,0,1,68027
2024-12-05,AMD RX 6600,33205,4.5,1594,81210,4.9,1335,93971,4.8,1601,-48005,-60766,4.733333333333333,1,269,8932145
2024-12-05,AMD RX 6700 XT,53752,3.9,1993,42149,4.5,1804,33533,4.1,258,11603,20219,4.166666666666667,0,1,53752
2024-12-05,NVIDIA RTX 4060,79898,4.2,1346,74362,3.8,1012,72283,4.6,431,5536,7615,4.2,0,15,1198470
2024-12-05,AMD RX 7900 XTX,31745,4.5,1447,76769,3.9,1329,91144,3.7,996,-45024,-59399,4.033333333333334,1,264,8380680
2024-12-04,NVIDIA RTX 3060,46000,3.5,381,78191,4.6,1760,37217,4.8,1114,-32191,8783,4.3,0,203,9338000
2024-12-04,NVIDIA RTX 3070,24829,4.2,810,75293,3.8,1391,49505,4.7,1097,-50464,-24676,4.233333333333333,1,285,7076265
2024-12-04,NVIDIA RTX 3080,94788,4.7,1576,78599,3.6,799,44813,4.1,118,16189,49975,4.133333333333334,0,1,94788
2024-12-04,AMD RX 6600,57347,4.1,1635,88296,3.8,1505,61858,4.2,702,-30949,-4511,4.033333333333333,1,167,9576949
2024-12-04,AMD RX 6700 XT,58194,4.7,160,46382,4.3,1425,61814,4.0,1921,11812,-3620,4.333333333333333,0,1,58194
2024-12-04,NVIDIA RTX 4060,69427,3.9,230,91457,3.9,995,75328,4.5,389,-22030,-5901,4.1000000000000005,1,153,10622331
2024-12-04,AMD RX 7900 XTX,62300,5.0,1385,36290,4.0,361,64322,4.5,1744,26010,-2022,4.5,0,1,62300
2024-12-03,NVIDIA RTX 3060,36165,4.2,837,63411,4.3,705,74914,4.4,1066,-27246,-38749,4.3,1,171,6184215
2024-12-03,NVIDIA RTX 3070,33358,4.8,441,32768,3.6,192,84395,4.9,1998,590,-51037,4.433333333333334,0,38,1267604
2024-12-03,NVIDIA RTX 3080,71481,3.9,310,90175,4.3,945,41084,4.3,1798,-18694,30397,4.166666666666667,0,142,10150302
2024-12-03,AMD RX 6600,38988,4.6,105,38190,4.5,1264,84191,4.0,467,798,-45203,4.366666666666666,0,21,818748
2024-12-03,AMD RX 6700 XT,27872,3.9,1066,58122,3.9,267,45560,3.6,111,-30250,-17688,3.8000000000000003,1,185,5156320
2024-12-03,NVIDIA RTX 4060,72844,4.9,466,88120,3.7,1454,68619,3.8,1521,-15276,4225,4.133333333333334,0,98,7138712
2024-12-03,AMD RX 7900 XTX,31164,4.7,1562,84140,4.7,1826,38705,4.2,293,-52976,-7541,4.533333333333334,1,281,8757084
2024-12-02,NVIDIA RTX 3060,78806,4.0,952,73875,3.6,1895,35128,4.2,420,4931,43678,3.9333333333333336,0,24,1891344
2024-12-02,NVIDIA RTX 3070,66156,4.7,1270,63584,4.4,1031,33621,4.5,1909,2572,32535,4.533333333333334,0,24,1587744
2024-12-02,NVIDIA RTX 3080,71842,4.3,1947,86085,4.7,799,54451,4.4,2000,-14243,17391,4.466666666666667,0,93,6681306
2024-12-02,AMD RX 6600,30372,3.8,1156,48264,3.8,1629,49498,3.9,1966,-17892,-19126,3.8333333333333335,1,125,3796500
2024-12-02,AMD RX 6700 XT,31303,3.6,1052,61505,3.7,1194,82645,4.6,852,-30202,-51342,3.966666666666667,1,174,5446722
2024-12-02,NVIDIA RTX 4060,61547,4.0,1232,24395,4.1,127,76943,4.3,1413,37152,-15396,4.133333333333333,0,1,61547
2024-12-02,AMD RX 7900 XTX,81931,4.1,697,49881,4.2,1516,49187,4.4,310,32050,32744,4.233333333333333,0,1,81931
2024-12-01,NVIDIA RTX 3060,66935,3.9,854,80484,4.9,1332,52662,3.8,1254,-13549,14273,4.2,0,100,6693500
2024-12-01,NVIDIA RTX 3070,88265,4.6,1219,88275,4.4,1363,36448,4.7,1302,-10,51817,4.566666666666666,0,37,3265805
2024-12-01,NVIDIA RTX 3080,55362,3.5,939,74938,4.5,1513,74897,4.4,1847,-19576,-19535,4.133333333333334,1,124,6864888
2024-12-01,AMD RX 6600,27041,4.3,1402,76252,3.6,376,63383,4.5,1069,-49211,-36342,4.133333333333334,1,273,7382193
2024-12-01,AMD RX 6700 XT,26001,3.5,1446,25381,3.7,132,50811,3.5,574,620,-24810,3.5666666666666664,0,24,624024
2024-12-01,NVIDIA RTX 4060,77276,4.0,520,46889,3.8,1428,51117,4.9,1359,30387,26159,4.233333333333333,0,1,77276
2024-12-01,AMD RX 7900 XTX,93394,4.1,222,46347,3.9,1824,42374,3.7,1891,47047,51020,3.9,0,1,93394
2024-11-30,NVIDIA RTX 3060,46490,3.9,189,47728,4.0,1049,24680,3.6,206,-1238,21810,3.8333333333333335,0,55,2556950
2024-11-30,NVIDIA RTX 3070,56596,4.1,1934,45302,4.1,338,44144,4.7,971,11294,12452,4.3,0,1,56596
2024-11-30,NVIDIA RTX 3080,74578,5.0,273,45019,4.6,1011,86504,4.0,1656,29559,-11926,4.533333333333333,0,1,74578
2024-11-30,AMD RX 6600,38667,3.7,1779,89438,3.5,1020,39346,4.3,872,-50771,-679,3.8333333333333335,1,300,11600100
2024-11-30,AMD RX 6700 XT,74301,4.4,227,55450,3.9,1798,78317,4.2,738,18851,-4016,4.166666666666667,0,1,74301
2024-11-30,NVIDIA RTX 4060,84440,4.9,584,73762,4.0,310,93013,4.3,1908,10678,-8573,4.3999999999999995,0,1,84440
2024-11-30,AMD RX 7900 XTX,62368,4.8,1996,82000,4.8,1609,51396,4.9,1807,-19632,10972,4.833333333333333,0,139,8669152
2024-11-29,NVIDIA RTX 3060,79245,4.7,768,60415,4.2,1095,64230,3.7,995,18830,15015,4.2,0,1,79245
2024-11-29,NVIDIA RTX 3070,67396,3.9,252,94127,4.6,1489,83901,4.5,613,-26731,-16505,4.333333333333333,1,168,11322528
2024-11-29,NVIDIA RTX 3080,49684,4.7,1297,87849,4.6,1181,42330,4.8,1435,-38165,7354,4.7,0,239,11874476
2024-11-29,AMD RX 6600,37556,3.7,1020,27949,4.4,1233,69094,3.5,848,9607,-31538,3.866666666666667,0,1,37556
2024-11-29,AMD RX 6700 XT,85658,4.1,1197,32518,4.8,954,88577,4.0,968,53140,-2919,4.3,0,1,85658
2024-11-29,NVIDIA RTX 4060,70661,4.2,1048,84998,4.2,1423,55074,4.3,1985,-14337,15587,4.233333333333333,0,107,7560727
2024-11-29,AMD RX 7900 XTX,57717,3.6,1753,71123,4.5,142,50165,4.1,1631,-13406,7552,4.066666666666666,0,78,4501926
2024-11-28,NVIDIA RTX 3060,67646,4.5,182,45505,4.6,1061,25002,4.2,1177,22141,42644,4.433333333333334,0,1,67646
2024-11-28,NVIDIA RTX 3070,52868,3.7,1556,70657,3.8,549,47589,4.4,772,-17789,5279,3.966666666666667,0,126,6661368
2024-11-28,NVIDIA RTX 3080,57448,4.1,200,71385,4.8,1564,37355,4.9,1129,-13937,20093,4.6,0,109,6261832
2024-11-28,AMD RX 6600,63300,4.7,456,84476,4.8,1580,28673,3.9,1425,-21176,34627,4.466666666666667,0,145,9178500
2024-11-28,AMD RX 6700 XT,29385,4.8,1238,76580,4.7,1478,63294,4.2,189,-47195,-33909,4.566666666666666,1,254,7463790
2024-11-28,NVIDIA RTX 4060,55523,4.2,1746,73088,4.7,1829,57412,4.4,1271,-17565,-1889,4.433333333333334,1,126,6995898
2024-11-28,AMD RX 7900 XTX,41316,3.5,1800,48331,3.8,1514,31870,4.9,1344,-7015,9446,4.066666666666666,0,61,2520276
2024-11-27,NVIDIA RTX 3060,52205,3.8,920,38761,4.2,454,85585,3.8,1635,13444,-33380,3.9333333333333336,0,1,52205
2024-11-27,NVIDIA RTX 3070,76412,4.4,1420,49426,4.4,306,35928,4.1,1355,26986,40484,4.3,0,1,76412
2024-11-27,NVIDIA RTX 3080,37785,4.4,1978,80567,4.0,528,47859,4.6,1883,-42782,-10074,4.333333333333333,1,243,9181755
2024-11-27,AMD RX 6600,32006,5.0,504,28314,4.0,634,39933,4.1,1832,3692,-7927,4.366666666666666,0,18,576108
2024-11-27,AMD RX 6700 XT,81176,3.6,1835,74343,3.7,1795,38112,4.2,1555,6833,43064,3.8333333333333335,0,1,81176
2024-11-27,NVIDIA RTX 4060,66459,3.6,1044,88252,4.7,791,32743,3.6,1214,-21793,33716,3.966666666666667,0,149,9902391
2024-11-27,AMD RX 7900 XTX,30013,4.9,987,79375,4.4,347,59959,4.5,1610,-49362,-29946,4.6000000000000005,1,270,8103510
2024-11-26,NVIDIA RTX 3060,77837,3.5,1499,55356,3.9,796,26910,4.8,1837,22481,50927,4.066666666666666,0,1,77837
2024-11-26,NVIDIA RTX 3070,79338,4.0,1960,68944,4.7,1240,69291,3.8,1301,10394,10047,4.166666666666667,0,1,79338
2024-11-26,NVIDIA RTX 3080,48782,3.9,1909,58298,4.8,1889,74234,3.5,1460,-9516,-25452,4.066666666666666,1,95,4634290
2024-11-26,AMD RX 6600,41764,4.4,1363,94502,4.5,1546,78254,4.8,1471,-52738,-36490,4.566666666666666,1,308,12863312
2024-11-26,AMD RX 6700 XT,59517,3.9,943,32194,4.7,1823,30590,3.8,1659,27323,28927,4.133333333333333,0,1,59517
2024-11-26,NVIDIA RTX 4060,85286,3.6,884,37406,4.7,1348,88943,4.6,271,47880,-3657,4.3,0,1,85286
2024-11-26,AMD RX 7900 XTX,43421,3.8,1911,39959,3.6,315,48253,3.6,1346,3462,-4832,3.6666666666666665,0,5,217105
2024-11-25,NVIDIA RTX 3060,92960,4.4,1742,49055,3.7,520,53682,4.3,454,43905,39278,4.133333333333334,0,1,92960
2024-11-25,NVIDIA RTX 3070,27692,4.7,835,70686,4.6,1550,24971,3.9,818,-42994,2721,4.4,0,251,6950692
2024-11-25,NVIDIA RTX 3080,89333,4.7,804,84014,4.2,1882,40226,4.2,1812,5319,49107,4.366666666666667,0,9,803997
2024-11-25,AMD RX 6600,90483,4.1,468,36277,4.5,785,37922,4.9,280,54206,52561,4.5,0,1,90483
2024-11-25,AMD RX 6700 XT,28028,4.4,160,41065,4.8,999,37979,3.8,276,-13037,-9951,4.333333333333333,1,91,2550548
2024-11-25,NVIDIA RTX 4060,59301,4.7,1066,76546,3.9,1757,48934,4.4,141,-17245,10367,4.333333333333333,0,104,6167304
2024-11-25,AMD RX 7900 XTX,94321,4.7,576,86880,3.9,450,44280,3.8,867,7441,50041,4.133333333333333,0,1,94321
2024-11-24,NVIDIA RTX 3060,43742,3.9,593,35350,4.1,1645,83003,4.8,605,8392,-39261,4.266666666666667,0,1,43742
2024-11-24,NVIDIA RTX 3070,61305,4.7,1978,79350,4.4,602,67918,4.5,1946,-18045,-6613,4.533333333333334,1,142,8705310
2024-11-24,NVIDIA RTX 3080,31125,4.4,1733,46209,4.1,567,48133,4.0,876,-15084,-17008,4.166666666666667,1,122,3797250
2024-11-24,AMD RX 6600,75817,4.9,1831,43599,4.1,938,61085,3.9,1257,32218,14732,4.3,0,1,75817
2024-11-24,AMD RX 6700 XT,46210,3.9,751,86357,4.7,840,66749,3.8,485,-40147,-20539,4.133333333333333,1,227,10489670
2024-11-24,NVIDIA RTX 4060,73872,3.5,1534,29526,3.7,120,59388,3.8,704,44346,14484,3.6666666666666665,0,1,73872
2024-11-24,AMD RX 7900 XTX,72745,4.3,1253,90379,3.6,744,61708,4.2,289,-17634,11037,4.033333333333334,0,133,9675085
2024-11-23,NVIDIA RTX 3060,50704,4.3,459,75991,4.2,905,89119,4.4,814,-25287,-38415,4.3,1,154,7808416
2024-11-23,NVIDIA RTX 3070,86592,3.6,576,32269,4.9,409,94239,4.7,1507,54323,-7647,4.3999999999999995,0,1,86592
2024-11-23,NVIDIA RTX 3080,50842,4.3,101,34751,5.0,1736,44644,4.9,1298,16091,6198,4.733333333333333,0,1,50842
2024-11-23,AMD RX 6600,70511,3.8,367,92550,4.1,1914,73826,4.3,531,-22039,-3315,4.066666666666666,1,138,9730518
2024-11-23,AMD RX 6700 XT,72536,3.8,1743,67798,4.6,1962,81707,4.5,1496,4738,-9171,4.3,0,1,72536
2024-11-23,NVIDIA RTX 4060,64900,3.5,1301,67173,4.7,1943,61538,4.0,1131,-2273,3362,4.066666666666666,0,48,3115200
2024-11-23,AMD RX 7900 XTX,41474,4.8,1862,96178,4.9,1534,57994,4.3,531,-54704,-16520,4.666666666666667,1,303,12566622
2024-11-22,NVIDIA RTX 3060,70420,4.1,1456,78599,4.5,1917,57631,4.2,164,-8179,12789,4.266666666666667,0,63,4436460
2024-11-22,NVIDIA RTX 3070,78651,3.7,718,85665,4.0,1762,41347,4.5,481,-7014,37304,4.066666666666666,0,59,4640409
2024-11-22,NVIDIA RTX 3080,65401,5.0,1599,76635,4.8,272,85431,4.2,761,-11234,-20030,4.666666666666667,1,95,6213095
2024-11-22,AMD RX 6600,84497,4.9,1429,31247,4.0,1585,75413,4.1,1305,53250,9084,4.333333333333333,0,1,84497
2024-11-22,AMD RX 6700 XT,65013,4.6,1250,42778,5.0,681,29076,4.6,1389,22235,35937,4.733333333333333,0,1,65013
2024-11-22,NVIDIA RTX 4060,70597,4.5,1768,50774,4.3,739,69103,3.7,1073,19823,1494,4.166666666666667,0,1,70597
2024-11-22,AMD RX 7900 XTX,48082,4.0,1510,93123,4.6,427,68629,4.5,305,-45041,-20547,4.366666666666666,1,240,11539680
2024-11-21,NVIDIA RTX 3060,61645,3.8,103,25297,4.8,1205,49457,4.0,1056,36348,12188,4.2,0,1,61645
2024-11-21,NVIDIA RTX 3070,77975,3.5,1333,57884,4.7,722,46578,4.2,1362,20091,31397,4.133333333333333,0,1,77975
2024-11-21,NVIDIA RTX 3080,68717,3.8,1258,81549,3.7,222,86689,4.4,990,-12832,-17972,3.966666666666667,1,113,7765021
2024-11-21,AMD RX 6600,39709,3.7,1626,73014,4.4,825,78220,4.8,617,-33305,-38511,4.300000000000001,1,180,7147620
2024-11-21,AMD RX 6700 XT,34147,4.0,754,38619,4.6,355,75840,4.0,1489,-4472,-41693,4.2,1,69,2356143
2024-11-21,NVIDIA RTX 4060,49216,4.8,281,83256,4.4,110,77038,3.6,1896,-34040,-27822,4.266666666666667,1,194,9547904
2024-11-21,AMD RX 7900 XTX,69665,3.5,529,84170,5.0,1749,56863,3.7,972,-14505,12802,4.066666666666666,0,100,6966500
2024-11-20,NVIDIA RTX 3060,60385,3.6,625,96777,3.9,712,62035,4.1,158,-36392,-1650,3.8666666666666667,1,227,13707395
2024-11-20,NVIDIA RTX 3070,42061,3.5,890,64757,4.7,1564,47694,3.7,715,-22696,-5633,3.9666666666666663,1,153,6435333
2024-11-20,NVIDIA RTX 3080,82875,5.0,1911,46197,4.1,1610,92317,4.9,1263,36678,-9442,4.666666666666667,0,1,82875
2024-11-20,AMD RX 6600,80305,4.8,819,55319,4.0,1292,41354,4.5,1714,24986,38951,4.433333333333334,0,1,80305
2024-11-20,AMD RX 6700 XT,72027,4.7,1715,50197,4.2,400,29791,4.0,1668,21830,42236,4.3,0,1,72027
2024-11-20,NVIDIA RTX 4060,52899,4.2,1736,81171,3.6,227,43376,4.2,438,-28272,9523,4.0,0,154,8146446
2024-11-20,AMD RX 7900 XTX,28794,3.5,634,78755,4.2,1013,82376,4.5,510,-49961,-53582,4.066666666666666,1,271,7803174
2024-11-19,NVIDIA RTX 3060,36333,4.0,1918,35258,4.5,924,47021,4.0,478,1075,-10688,4.166666666666667,0,43,1562319
2024-11-19,NVIDIA RTX 3070,72530,4.6,1220,93253,4.8,1296,54622,4.2,1583,-20723,17908,4.533333333333332,0,120,8703600
2024-11-19,NVIDIA RTX 3080,36971,4.4,1356,92595,4.1,1001,55339,4.5,1831,-55624,-18368,4.333333333333333,1,294,10869474
2024-11-19,AMD RX 6600,91044,3.5,1438,92159,5.0,1787,71094,4.2,805,-1115,19950,4.233333333333333,0,21,1911924
2024-11-19,AMD RX 6700 XT,48601,4.8,421,44526,4.3,1092,38951,4.3,907,4075,9650,4.466666666666666,0,9,437409
2024-11-19,NVIDIA RTX 4060,29848,4.0,489,83052,5.0,1151,53720,4.5,1802,-53204,-23872,4.5,1,288,8596224
2024-11-19,AMD RX 7900 XTX,81356,4.3,1995,92322,4.5,1032,88534,3.9,1977,-10966,-7178,4.233333333333333,1,100,8135600
2024-11-18,NVIDIA RTX 3060,62179,3.9,586,84310,4.6,1244,37734,3.7,1662,-22131,24445,4.066666666666666,0,128,7958912
2024-11-18,NVIDIA RTX 3070,34977,4.1,1225,71381,4.4,936,42776,4.7,1939,-36404,-7799,4.3999999999999995,1,222,7764894
2024-11-18,NVIDIA RTX 3080,87607,3.6,107,37451,4.1,693,64645,4.6,969,50156,22962,4.1,0,1,87607
2024-11-18,AMD RX 6600,78764,3.9,1455,31561,3.7,860,77997,3.6,1100,47203,767,3.733333333333333,0,1,78764
2024-11-18,AMD RX 6700 XT,86592,3.6,523,65034,4.0,1095,27341,4.8,464,21558,59251,4.133333333333333,0,1,86592
2024-11-18,NVIDIA RTX 4060,49619,3.9,267,26837,3.7,1307,55845,4.0,1126,22782,-6226,3.8666666666666667,0,1,49619
2024-11-18,AMD RX 7900 XTX,85017,4.0,914,77678,4.9,724,27209,4.4,915,7339,57808,4.433333333333334,0,8,680136
2024-11-17,NVIDIA RTX 3060,87733,4.8,642,60922,3.8,1614,37415,3.8,1123,26811,50318,4.133333333333333,0,1,87733
2024-11-17,NVIDIA RTX 3070,39203,4.3,478,86084,3.7,814,46999,3.8,991,-46881,-7796,3.9333333333333336,1,261,10231983
2024-11-17,NVIDIA RTX 3080,73754,4.1,1012,31221,4.1,1273,36951,4.1,468,42533,36803,4.1,0,1,73754
2024-11-17,AMD RX 6600,30004,4.2,639,67227,4.2,791,79032,3.9,892,-37223,-49028,4.1000000000000005,1,217,6510868
2024-11-17,AMD RX 6700 XT,53854,4.3,409,75347,4.8,1807,85285,3.9,963,-21493,-31431,4.333333333333333,1,129,6947166
2024-11-17,NVIDIA RTX 4060,35377,4.5,1755,40541,4.3,1043,46868,4.1,1159,-5164,-11491,4.3,1,55,1945735
2024-11-17,AMD RX 7900 XTX,81093,3.8,224,86438,4.2,1874,39758,4.7,809,-5345,41335,4.233333333333333,0,69,5595417
2024-11-16,NVIDIA RTX 3060,77018,4.1,1196,65357,4.7,1460,40663,4.8,1745,11661,36355,4.533333333333334,0,1,77018
2024-11-16,NVIDIA RTX 3070,88927,4.8,1075,78862,3.8,909,24919,4.0,1276,10065,64008,4.2,0,1,88927
2024-11-16,NVIDIA RTX 3080,61817,4.1,1848,70864,3.6,1473,91594,4.5,123,-9047,-29777,4.066666666666666,1,88,5439896
2024-11-16,AMD RX 6600,30664,4.4,1158,82349,4.5,1873,91075,4.9,922,-51685,-60411,4.6000000000000005,1,273,8371272
2024-11-16,AMD RX 6700 XT,42311,4.9,1019,49500,3.5,1390,77818,4.0,629,-7189,-35507,4.133333333333334,1,74,3131014
2024-11-16,NVIDIA RTX 4060,46028,5.0,1755,67077,4.5,1418,42142,4.7,1960,-21049,3886,4.733333333333333,0,126,5799528
2024-11-16,AMD RX 7900 XTX,48293,3.6,260,34737,4.9,1209,85129,4.1,1069,13556,-36836,4.2,0,1,48293
2024-11-15,NVIDIA RTX 3060,80721,5.0,1384,33601,4.3,1637,70299,5.0,328,47120,10422,4.766666666666667,0,1,80721
2024-11-15,NVIDIA RTX 3070,46256,3.9,1965,88485,4.8,346,48913,4.3,885,-42229,-2657,4.333333333333333,1,252,11656512
2024-11-15,NVIDIA RTX 3080,31495,4.1,913,93183,4.9,663,33717,3.5,1549,-61688,-2222,4.166666666666667,1,328,10330360
2024-11-15,AMD RX 6600,67008,4.3,1978,50984,4.7,1818,57413,4.3,1358,16024,9595,4.433333333333334,0,1,67008
2024-11-15,AMD RX 6700 XT,29357,4.4,1170,80919,4.7,1342,85198,3.6,676,-51562,-55841,4.233333333333333,1,285,8366745
2024-11-15,NVIDIA RTX 4060,77918,4.1,403,67290,4.4,1106,28217,4.8,1042,10628,49701,4.433333333333334,0,1,77918
2024-11-15,AMD RX 7900 XTX,35998,4.3,306,27833,4.2,949,70527,4.8,1505,8165,-34529,4.433333333333334,0,1,35998
2024-11-14,NVIDIA RTX 3060,63885,4.8,1897,29477,4.0,626,72471,4.1,1482,34408,-8586,4.3,0,1,63885
2024-11-14,NVIDIA RTX 3070,78019,4.1,1094,34869,5.0,1209,61008,4.3,466,43150,17011,4.466666666666666,0,1,78019
2024-11-14,NVIDIA RTX 3080,84309,3.8,925,46377,3.7,623,63358,4.1,1014,37932,20951,3.8666666666666667,0,1,84309
2024-11-14,AMD RX 6600,45919,4.4,1520,35010,4.0,934,66988,4.5,1320,10909,-21069,4.3,0,1,45919
2024-11-14,AMD RX 6700 XT,74971,4.1,1900,44658,4.4,766,39564,4.6,1188,30313,35407,4.366666666666666,0,1,74971
2024-11-14,NVIDIA RTX 4060,71105,3.9,1627,46006,4.6,710,75968,3.8,1195,25099,-4863,4.1000000000000005,0,1,71105
2024-11-14,AMD RX 7900 XTX,86487,4.8,141,73918,4.0,945,35427,4.6,1396,12569,51060,4.466666666666667,0,1,86487
2024-11-13,NVIDIA RTX 3060,68766,4.0,1826,66607,4.1,1795,90208,4.8,807,2159,-21442,4.3,0,15,1031490
2024-11-13,NVIDIA RTX 3070,92140,4.5,1879,38279,3.8,1640,87679,4.4,1981,53861,4461,4.233333333333333,0,1,92140
2024-11-13,NVIDIA RTX 3080,52978,4.0,1623,57035,4.3,1133,95284,4.2,256,-4057,-42306,4.166666666666667,1,71,3761438
2024-11-13,AMD RX 6600,82707,3.9,953,73411,3.9,751,67859,3.6,1347,9296,14848,3.8000000000000003,0,2,165414
2024-11-13,AMD RX 6700 XT,35242,4.2,1970,87456,4.1,1091,38382,4.3,1585,-52214,-3140,4.2,1,274,9656308
2024-11-13,NVIDIA RTX 4060,79336,4.6,1876,29126,4.5,1971,35090,4.9,1634,50210,44246,4.666666666666667,0,1,79336
2024-11-13,AMD RX 7900 XTX,71469,4.3,425,26644,4.3,1300,65042,4.1,476,44825,6427,4.233333333333333,0,1,71469
2024-11-12,NVIDIA RTX 3060,33148,4.6,926,37322,4.6,1434,61577,4.5,1908,-4174,-28429,4.566666666666666,1,41,1359068
2024-11-12,NVIDIA RTX 3070,44073,4.8,159,40953,4.4,1013,35941,4.9,1725,3120,8132,4.7,0,1,44073
2024-11-12,NVIDIA RTX 3080,46351,4.8,511,38206,4.3,1703,51795,3.9,720,8145,-5444,4.333333333333333,0,1,46351
2024-11-12,AMD RX 6600,31596,3.5,203,43718,4.3,444,93792,4.8,599,-12122,-62196,4.2,1,99,3128004
2024-11-12,AMD RX 6700 XT,75007,3.8,854,58536,4.9,1966,31465,4.4,540,16471,43542,4.366666666666666,0,1,75007
2024-11-12,NVIDIA RTX 4060,86983,4.1,1990,81552,3.5,1051,81522,4.6,1693,5431,5461,4.066666666666666,0,15,1304745
2024-11-12,AMD RX 7900 XTX,43816,3.5,862,65261,5.0,101,48608,4.3,193,-21445,-4792,4.266666666666667,1,142,6221872
2024-11-11,NVIDIA RTX 3060,90932,4.2,1882,33837,3.9,613,75738,4.5,658,57095,15194,4.2,0,1,90932
2024-11-11,NVIDIA RTX 3070,89011,4.3,805,74705,4.8,535,25997,3.8,1701,14306,63014,4.3,0,1,89011
2024-11-11,NVIDIA RTX 3080,45550,4.6,1510,91193,3.6,1613,81689,3.7,646,-45643,-36139,3.9666666666666663,1,265,12070750
2024-11-11,AMD RX 6600,36182,3.5,201,33628,3.6,1530,87520,4.7,1400,2554,-51338,3.9333333333333336,0,30,1085460
2024-11-11,AMD RX 6700 XT,48039,4.7,538,39262,4.6,672,64496,3.8,137,8777,-16457,4.366666666666667,0,1,48039
2024-11-11,NVIDIA RTX 4060,56315,3.8,523,80345,4.4,1742,66357,3.6,689,-24030,-10042,3.933333333333333,1,163,9179345
2024-11-11,AMD RX 7900 XTX,62606,4.1,141,69307,4.9,1400,87193,4.1,1319,-6701,-24587,4.366666666666666,1,67,4194602
2024-11-10,NVIDIA RTX 3060,27049,4.9,1425,62054,4.2,603,69525,4.1,1242,-35005,-42476,4.4,1,226,6113074
2024-11-10,NVIDIA RTX 3070,49625,4.7,558,66955,3.8,1327,26456,4.0,809,-17330,23169,4.166666666666667,0,135,6699375
2024-11-10,NVIDIA RTX 3080,60064,4.7,725,65181,4.9,373,81489,4.2,1620,-5117,-21425,4.6000000000000005,1,63,3784032
2024-11-10,AMD RX 6600,61565,4.8,1844,27255,4.2,1946,89126,4.3,448,34310,-27561,4.433333333333334,0,1,61565
2024-11-10,AMD RX 6700 XT,71466,3.9,1055,28765,3.8,1238,75220,4.1,1453,42701,-3754,3.933333333333333,0,1,71466
2024-11-10,NVIDIA RTX 4060,67149,4.3,1377,89308,4.3,1712,37475,4.2,807,-22159,29674,4.266666666666667,0,148,9938052
2024-11-10,AMD RX 7900 XTX,78843,3.7,1147,36573,3.5,1804,34591,4.6,1184,42270,44252,3.9333333333333336,0,1,78843
2024-11-09,NVIDIA RTX 3060,75650,4.5,1347,85857,3.7,1764,72880,3.9,745,-10207,2770,4.033333333333333,0,95,7186750
2024-11-09,NVIDIA RTX 3070,61496,4.5,1086,76257,4.0,462,86703,4.2,419,-14761,-25207,4.233333333333333,1,117,7195032
2024-11-09,NVIDIA RTX 3080,33121,5.0,1411,24127,4.2,495,48967,4.0,983,8994,-15846,4.3999999999999995,0,1,33121
2024-11-09,AMD RX 6600,66884,3.9,1556,80347,3.8,140,76637,4.6,681,-13463,-9753,4.1,1,80,5350720
2024-11-09,AMD RX 6700 XT,62706,3.7,1667,64423,4.9,832,88246,4.1,1200,-1717,-25540,4.233333333333333,1,32,2006592
2024-11-09,NVIDIA RTX 4060,53961,4.7,1743,47838,4.7,1380,42361,4.4,1840,6123,11600,4.6000000000000005,0,1,53961
2024-11-09,AMD RX 7900 XTX,80376,4.0,386,67618,3.8,1111,38980,4.1,532,12758,41396,3.9666666666666663,0,1,80376
2024-11-08,NVIDIA RTX 3060,30705,4.2,705,69880,3.9,1952,41175,3.9,1871,-39175,-10470,4.0,1,230,7062150
2024-11-08,NVIDIA RTX 3070,59431,4.1,1608,49463,3.8,1781,46140,4.3,820,9968,13291,4.066666666666666,0,1,59431
2024-11-08,NVIDIA RTX 3080,31405,4.6,1271,74823,4.8,1265,53966,4.9,671,-43418,-22561,4.766666666666667,1,236,7411580
2024-11-08,AMD RX 6600,49703,4.6,555,91624,3.8,496,66839,4.4,1460,-41921,-17136,4.266666666666667,1,260,12922780
2024-11-08,AMD RX 6700 XT,89858,4.0,714,45541,4.4,1627,67765,4.3,903,44317,22093,4.233333333333333,0,1,89858
2024-11-08,NVIDIA RTX 4060,49667,4.8,470,31569,3.9,1267,54813,4.2,1050,18098,-5146,4.3,0,1,49667
2024-11-08,AMD RX 7900 XTX,61305,4.2,1617,56164,4.6,661,63204,3.7,1888,5141,-1899,4.166666666666667,0,10,613050
2024-11-07,NVIDIA RTX 3060,61842,4.7,1662,52700,3.5,1519,48558,3.9,1190,9142,13284,4.033333333333333,0,1,61842
2024-11-07,NVIDIA RTX 3070,51563,4.8,1440,96886,3.9,1247,69586,4.5,1499,-45323,-18023,4.3999999999999995,1,262,13509506
2024-11-07,NVIDIA RTX 3080,35524,4.0,1624,81513,4.9,1412,38027,4.4,956,-45989,-2503,4.433333333333334,1,242,8596808
2024-11-07,AMD RX 6600,65694,4.7,778,31443,4.1,933,80184,3.8,159,34251,-14490,4.2,0,1,65694
2024-11-07,AMD RX 6700 XT,72851,4.4,1049,58915,4.5,1055,52520,4.4,1130,13936,20331,4.433333333333334,0,1,72851
2024-11-07,NVIDIA RTX 4060,41291,3.6,1399,89916,4.3,189,37463,4.4,937,-48625,3828,4.1000000000000005,0,265,10942115
2024-11-07,AMD RX 7900 XTX,35202,4.8,1124,51815,3.9,960,27654,4.4,440,-16613,7548,4.366666666666666,0,97,3414594
2024-11-06,NVIDIA RTX 3060,43280,4.1,711,95461,4.0,902,89460,3.6,858,-52181,-46180,3.9,1,285,12334800
2024-11-06,NVIDIA RTX 3070,76588,4.8,408,50248,3.6,1271,29903,4.8,1439,26340,46685,4.3999999999999995,0,1,76588
2024-11-06,NVIDIA RTX 3080,41644,4.0,1266,27173,5.0,967,77553,4.3,495,14471,-35909,4.433333333333334,0,1,41644
2024-11-06,AMD RX 6600,83147,4.0,1565,33804,3.8,774,46902,4.1,1891,49343,36245,3.9666666666666663,0,1,83147
2024-11-06,AMD RX 6700 XT,46301,4.2,1392,63251,4.4,298,54802,4.2,1559,-16950,-8501,4.266666666666667,1,124,5741324
2024-11-06,NVIDIA RTX 4060,47743,4.5,109,29584,4.1,149,50829,3.7,232,18159,-3086,4.1000000000000005,0,1,47743
2024-11-06,AMD RX 7900 XTX,83491,3.8,1684,67868,3.9,1069,27743,4.4,1040,15623,55748,4.033333333333333,0,1,83491
2024-11-05,NVIDIA RTX 3060,48819,4.6,1102,56033,4.7,1782,59718,4.4,595,-7214,-10899,4.566666666666667,1,67,3270873
2024-11-05,NVIDIA RTX 3070,34599,4.4,1397,69981,4.7,249,48962,4.3,327,-35382,-14363,4.466666666666668,1,214,7404186
2024-11-05,NVIDIA RTX 3080,81587,4.1,1077,80261,4.4,1285,66722,3.9,1578,1326,14865,4.133333333333334,0,19,1550153
2024-11-05,AMD RX 6600,72280,3.6,508,39061,5.0,1977,31210,4.6,1496,33219,41070,4.3999999999999995,0,1,72280
2024-11-05,AMD RX 6700 XT,71018,4.8,1650,29461,4.0,1836,79517,5.0,1865,41557,-8499,4.6000000000000005,0,1,71018
2024-11-05,NVIDIA RTX 4060,93164,3.5,108,31567,3.6,1743,73080,4.7,632,61597,20084,3.9333333333333336,0,1,93164
2024-11-05,AMD RX 7900 XTX,56466,4.5,805,80371,4.0,1382,43720,4.7,1425,-23905,12746,4.3999999999999995,0,160,9034560
2024-11-04,NVIDIA RTX 3060,63962,3.7,1130,79140,3.7,214,28701,4.2,1586,-15178,35261,3.866666666666667,0,102,6524124
2024-11-04,NVIDIA RTX 3070,63491,3.6,193,31257,4.8,922,32235,4.7,1796,32234,31256,4.366666666666667,0,1,63491
2024-11-04,NVIDIA RTX 3080,63467,4.2,1165,39616,4.6,577,30206,4.1,1999,23851,33261,4.3,0,1,63467
2024-11-04,AMD RX 6600,93464,4.2,1506,27104,4.1,1728,94205,4.5,977,66360,-741,4.266666666666667,0,1,93464
2024-11-04,AMD RX 6700 XT,42343,5.0,1103,83192,4.4,795,39108,3.7,637,-40849,3235,4.366666666666667,0,246,10416378
2024-11-04,NVIDIA RTX 4060,70630,3.7,1957,29123,4.3,1303,42565,3.8,945,41507,28065,3.9333333333333336,0,1,70630
2024-11-04,AMD RX 7900 XTX,75029,3.8,1589,48112,3.7,1318,67704,4.9,1729,26917,7325,4.133333333333334,0,1,75029
2024-11-03,NVIDIA RTX 3060,40927,4.6,1307,35709,4.7,496,86975,3.9,775,5218,-46048,4.4,0,15,613905
2024-11-03,NVIDIA RTX 3070,89527,3.7,1556,43733,4.3,827,35461,4.8,1106,45794,54066,4.266666666666667,0,1,89527
2024-11-03,NVIDIA RTX 3080,29970,4.8,623,81125,4.6,1010,56206,4.0,1511,-51155,-26236,4.466666666666666,1,295,8841150
2024-11-03,AMD RX 6600,33233,5.0,1455,48360,3.7,190,82992,4.7,1532,-15127,-49759,4.466666666666666,1,92,3057436
2024-11-03,AMD RX 6700 XT,41524,4.8,198,30973,4.0,992,60460,3.9,173,10551,-18936,4.233333333333333,0,1,41524
2024-11-03,NVIDIA RTX 4060,40590,4.2,353,94594,4.6,737,41564,4.3,153,-54004,-974,4.366666666666667,1,290,11771100
2024-11-03,AMD RX 7900 XTX,59012,4.6,520,42294,4.2,1335,54007,4.3,1561,16718,5005,4.366666666666667,0,1,59012
2024-11-02,NVIDIA RTX 3060,25685,4.1,306,69328,4.1,116,62682,4.9,424,-43643,-36997,4.366666666666666,1,235,6035975
2024-11-02,NVIDIA RTX 3070,92408,4.4,1535,94657,4.5,396,65836,4.6,1478,-2249,26572,4.5,0,41,3788728
2024-11-02,NVIDIA RTX 3080,43409,4.7,314,31456,4.3,1810,61915,4.6,1523,11953,-18506,4.533333333333333,0,1,43409
2024-11-02,AMD RX 6600,94942,4.4,678,32614,4.0,510,40049,4.4,1859,62328,54893,4.266666666666667,0,1,94942
2024-11-02,AMD RX 6700 XT,37813,4.2,1347,48939,4.0,1467,74468,4.5,157,-11126,-36655,4.233333333333333,1,89,3365357
2024-11-02,NVIDIA RTX 4060,50335,4.7,513,90045,4.5,1057,54519,4.0,1296,-39710,-4184,4.3999999999999995,1,240,12080400
2024-11-02,AMD RX 7900 XTX,74675,4.1,428,70141,4.3,787,25706,4.0,1141,4534,48969,4.133333333333333,0,12,896100
2024-11-01,NVIDIA RTX 3060,31654,4.2,525,64702,4.0,314,93064,4.2,1943,-33048,-61410,4.133333333333333,1,203,6425762
2024-11-01,NVIDIA RTX 3070,87709,3.9,126,81891,4.2,1984,47154,4.5,1302,5818,40555,4.2,0,1,87709
2024-11-01,NVIDIA RTX 3080,34569,4.8,1470,27716,3.8,571,90253,4.3,874,6853,-55684,4.3,0,16,553104
2024-11-01,AMD RX 6600,87984,4.9,1696,88260,3.8,1084,90913,3.8,1175,-276,-2929,4.166666666666667,1,32,2815488
2024-11-01,AMD RX 6700 XT,89684,4.6,307,68531,3.8,477,86619,4.2,877,21153,3065,4.199999999999999,0,1,89684
2024-11-01,NVIDIA RTX 4060,60818,3.8,706,25853,3.5,832,29343,4.9,801,34965,31475,4.066666666666666,0,1,60818
2024-11-01,AMD RX 7900 XTX,60422,3.6,1765,30478,3.7,695,54001,3.8,407,29944,6421,3.7000000000000006,0,1,60422
2024-10-31,NVIDIA RTX 3060,45221,4.8,837,81317,4.4,1969,63464,4.7,1716,-36096,-18243,4.633333333333333,1,223,10084283
2024-10-31,NVIDIA RTX 3070,66476,4.6,294,69533,5.0,507,42999,3.8,1121,-3057,23477,4.466666666666666,0,30,1994280
2024-10-31,NVIDIA RTX 3080,28093,4.8,1458,50256,3.8,1913,86868,4.9,1956,-22163,-58775,4.5,1,154,4326322
2024-10-31,AMD RX 6600,47041,4.0,996,62228,3.8,1835,27892,4.8,1618,-15187,19149,4.2,0,91,4280731
2024-10-31,AMD RX 6700 XT,57928,4.1,801,55701,3.8,460,51524,4.5,916,2227,6404,4.133333333333333,0,22,1274416
2024-10-31,NVIDIA RTX 4060,46901,4.1,1034,57141,3.5,1487,37654,4.3,655,-10240,9247,3.9666666666666663,0,83,3892783
2024-10-31,AMD RX 7900 XTX,60788,4.5,1079,43092,4.5,1912,32871,4.2,1170,17696,27917,4.3999999999999995,0,1,60788
2024-10-30,NVIDIA RTX 3060,82593,4.8,441,39316,4.9,724,56506,3.9,1614,43277,26087,4.533333333333333,0,1,82593
2024-10-30,NVIDIA RTX 3070,37903,4.5,220,83762,4.1,862,51594,4.9,1856,-45859,-13691,4.5,1,273,10347519
2024-10-30,NVIDIA RTX 3080,43741,4.1,1309,48776,5.0,1376,55994,4.5,1034,-5035,-12253,4.533333333333333,1,46,2012086
2024-10-30,AMD RX 6600,89925,4.5,471,84672,3.6,395,45585,5.0,644,5253,44340,4.366666666666666,0,1,89925
2024-10-30,AMD RX 6700 XT,74711,4.4,1866,40696,3.8,874,59117,4.6,1601,34015,15594,4.266666666666667,0,1,74711
2024-10-30,NVIDIA RTX 4060,43082,4.9,331,73658,4.4,1402,31430,4.3,224,-30576,11652,4.533333333333334,0,175,7539350
2024-10-30,AMD RX 7900 XTX,79517,3.6,635,54431,4.6,1302,51091,3.9,1659,25086,28426,4.033333333333333,0,1,79517
2024-10-29,NVIDIA RTX 3060,63288,4.6,1488,51171,3.9,404,88361,3.6,1905,12117,-25073,4.033333333333333,0,1,63288
2024-10-29,NVIDIA RTX 3070,95511,4.6,558,66973,3.6,1729,31307,4.7,249,28538,64204,4.3,0,1,95511
2024-10-29,NVIDIA RTX 3080,70593,4.3,1534,59744,4.8,1296,51663,3.7,270,10849,18930,4.266666666666667,0,1,70593
2024-10-29,AMD RX 6600,38028,4.5,609,87806,4.6,1706,86011,3.6,1307,-49778,-47983,4.233333333333333,1,293,11142204
2024-10-29,AMD RX 6700 XT,87999,4.5,1413,89126,4.4,442,55080,4.2,1265,-1127,32919,4.366666666666667,0,31,2727969
2024-10-29,NVIDIA RTX 4060,73663,4.8,1243,91844,4.6,1421,28023,4.1,1953,-18181,45640,4.499999999999999,0,144,10607472
2024-10-29,AMD RX 7900 XTX,29247,4.5,421,91801,4.2,1050,42515,4.8,1692,-62554,-13268,4.5,1,358,10470426
2024-10-28,NVIDIA RTX 3060,92109,4.8,1880,48097,4.6,1176,52356,4.7,1358,44012,39753,4.699999999999999,0,1,92109
2024-10-28,NVIDIA RTX 3070,44292,4.6,756,91208,4.9,1070,81806,3.9,933,-46916,-37514,4.466666666666667,1,248,10984416
2024-10-28,NVIDIA RTX 3080,56284,5.0,203,61932,4.1,1986,61521,4.4,773,-5648,-5237,4.5,1,69,3883596
2024-10-28,AMD RX 6600,90268,4.3,875,28494,3.8,515,92450,4.3,1421,61774,-2182,4.133333333333333,0,1,90268
2024-10-28,AMD RX 6700 XT,76783,3.6,1009,83175,4.1,726,63438,4.8,609,-6392,13345,4.166666666666667,0,63,4837329
2024-10-28,NVIDIA RTX 4060,81454,4.8,1015,80797,4.4,1825,68969,4.5,1130,657,12485,4.566666666666666,0,48,3909792
2024-10-28,AMD RX 7900 XTX,64398,5.0,1626,73119,4.3,375,67602,4.2,1649,-8721,-3204,4.5,1,86,5538228
2024-10-27,NVIDIA RTX 3060,25169,4.1,173,35430,4.2,820,49872,3.5,1929,-10261,-24703,3.9333333333333336,1,84,2114196
2024-10-27,NVIDIA RTX 3070,22766,4.7,1367,56952,3.6,1149,92641,4.2,466,-34186,-69875,4.166666666666667,1,222,5054052
2024-10-27,NVIDIA RTX 3080,66088,4.3,1440,69579,4.2,985,34132,4.5,293,-3491,31956,4.333333333333333,0,49,3238312
2024-10-27,AMD RX 6600,84588,4.0,211,78612,4.7,749,82895,4.5,1203,5976,1693,4.3999999999999995,0,1,84588
2024-10-27,AMD RX 6700 XT,54940,4.0,1671,60917,3.5,1004,47526,4.7,1662,-5977,7414,4.066666666666666,0,64,3516160
2024-10-27,NVIDIA RTX 4060,89884,4.5,1566,54818,4.5,835,54128,4.0,725,35066,35756,4.333333333333333,0,1,89884
2024-10-27,AMD RX 7900 XTX,82248,3.6,1449,35214,4.8,1150,68290,4.2,1502,47034,13958,4.2,0,1,82248
2024-10-26,NVIDIA RTX 3060,51081,4.0,1799,34508,4.9,301,66322,3.8,1476,16573,-15241,4.233333333333333,0,1,51081
2024-10-26,NVIDIA RTX 3070,64756,4.3,1537,38127,4.0,1218,44915,3.7,1669,26629,19841,4.0,0,1,64756
2024-10-26,NVIDIA RTX 3080,36310,4.8,1108,50988,3.8,774,75342,4.8,1349,-14678,-39032,4.466666666666666,1,114,4139340
2024-10-26,AMD RX 6600,46280,4.6,938,57250,4.6,1673,45262,4.9,1070,-10970,1018,4.7,0,98,4535440
2024-10-26,AMD RX 6700 XT,38102,4.4,484,59535,4.6,382,82596,3.9,638,-21433,-44494,4.3,1,146,5562892
2024-10-26,NVIDIA RTX 4060,41044,3.8,1788,56296,4.7,677,86350,4.1,727,-15252,-45306,4.2,1,119,4884236
2024-10-26,AMD RX 7900 XTX,52850,4.0,1650,70741,4.9,1783,71694,4.0,1626,-17891,-18844,4.3,1,102,5390700
2024-10-25,NVIDIA RTX 3060,76705,4.9,1815,27424,4.5,1658,67017,4.0,1253,49281,9688,4.466666666666667,0,1,76705
2024-10-25,NVIDIA RTX 3070,41840,4.2,1306,44822,3.8,1581,76999,3.5,927,-2982,-35159,3.8333333333333335,1,62,2594080
2024-10-25,NVIDIA RTX 3080,89188,4.9,108,53394,3.9,1302,32597,4.0,1749,35794,56591,4.266666666666667,0,1,89188
2024-10-25,AMD RX 6600,91912,4.3,986,89356,4.7,797,44082,4.7,139,2556,47830,4.566666666666666,0,3,275736
2024-10-25,AMD RX 6700 XT,89462,4.7,1964,35819,4.8,978,50212,4.5,624,53643,39250,4.666666666666667,0,1,89462
2024-10-25,NVIDIA RTX 4060,50893,4.4,1596,78463,4.2,1846,63698,3.5,975,-27570,-12805,4.033333333333334,1,174,8855382
2024-10-25,AMD RX 7900 XTX,39675,4.1,1329,29014,3.7,1889,74790,4.3,1613,10661,-35115,4.033333333333333,0,1,39675
2024-10-24,NVIDIA RTX 3060,68313,4.8,957,41325,4.9,119,49903,4.4,1001,26988,18410,4.7,0,1,68313
2024-10-24,NVIDIA RTX 3070,56778,4.1,802,92906,4.8,795,58783,3.6,428,-36128,-2005,4.166666666666666,1,232,13172496
2024-10-24,NVIDIA RTX 3080,64266,4.7,382,54988,4.1,1641,70582,4.2,1577,9278,-6316,4.333333333333333,0,1,64266
2024-10-24,AMD RX 6600,81034,4.6,1632,80526,4.3,767,83963,4.7,898,508,-2929,4.533333333333332,0,19,1539646
2024-10-24,AMD RX 6700 XT,91595,4.8,1221,29695,4.7,1988,87883,3.9,1342,61900,3712,4.466666666666667,0,1,91595
2024-10-24,NVIDIA RTX 4060,68975,4.6,1233,41495,5.0,776,71639,3.7,1409,27480,-2664,4.433333333333334,0,1,68975
2024-10-24,AMD RX 7900 XTX,52132,3.8,1563,76357,3.8,900,69178,4.3,997,-24225,-17046,3.9666666666666663,1,136,7089952
2024-10-23,NVIDIA RTX 3060,65710,4.0,1477,34728,4.1,1072,60164,4.2,1903,30982,5546,4.1000000000000005,0,1,65710
2024-10-23,NVIDIA RTX 3070,45208,4.5,464,38932,4.4,1024,34355,5.0,1600,6276,10853,4.633333333333334,0,5,226040
2024-10-23,NVIDIA RTX 3080,92490,4.5,760,62693,3.8,1482,77477,4.8,1307,29797,15013,4.366666666666667,0,1,92490
2024-10-23,AMD RX 6600,40011,4.3,1293,45545,4.7,1335,65873,3.8,280,-5534,-25862,4.266666666666667,1,64,2560704
2024-10-23,AMD RX 6700 XT,82242,4.6,1823,86262,3.8,242,81451,4.0,1219,-4020,791,4.133333333333333,0,46,3783132
2024-10-23,NVIDIA RTX 4060,94321,4.8,965,74904,3.8,696,60732,4.3,696,19417,33589,4.3,0,1,94321
2024-10-23,AMD RX 7900 XTX,27955,3.7,880,91306,4.2,854,26014,4.7,239,-63351,1941,4.2,0,329,9197195
2024-10-22,NVIDIA RTX 3060,41482,4.5,509,90054,3.8,1860,66110,4.9,1013,-48572,-24628,4.4,1,274,11366068
2024-10-22,NVIDIA RTX 3070,58311,5.0,1499,79055,3.7,326,51663,4.0,566,-20744,6648,4.233333333333333,0,117,6822387
2024-10-22,NVIDIA RTX 3080,56040,4.8,1514,43320,4.1,1621,85365,4.0,1487,12720,-29325,4.3,0,1,56040
2024-10-22,AMD RX 6600,62355,4.6,166,34198,4.9,1872,58042,4.4,147,28157,4313,4.633333333333334,0,1,62355
2024-10-22,AMD RX 6700 XT,72720,3.7,1877,50127,4.8,734,41361,4.5,975,22593,31359,4.333333333333333,0,1,72720
2024-10-22,NVIDIA RTX 4060,56701,4.3,586,84462,4.5,425,77928,4.7,1803,-27761,-21227,4.5,1,186,10546386
2024-10-22,AMD RX 7900 XTX,94669,3.9,1460,67485,3.8,1567,91751,4.9,1149,27184,2918,4.2,0,1,94669
2024-10-21,NVIDIA RTX 3060,31282,4.1,1714,84412,3.8,392,71084,4.3,165,-53130,-39802,4.066666666666666,1,303,9478446
2024-10-21,NVIDIA RTX 3070,67503,3.6,1623,80946,4.7,1338,90767,4.7,1107,-13443,-23264,4.333333333333333,1,86,5805258
2024-10-21,NVIDIA RTX 3080,56606,4.4,1699,58660,4.0,1265,63755,4.0,237,-2054,-7149,4.133333333333334,1,49,2773694
2024-10-21,AMD RX 6600,81920,4.9,1543,90119,4.2,180,36532,3.6,1243,-8199,45388,4.233333333333333,0,89,7290880
2024-10-21,AMD RX 6700 XT,75020,4.3,1335,36299,4.5,1981,41079,3.7,1151,38721,33941,4.166666666666667,0,1,75020
2024-10-21,NVIDIA RTX 4060,53689,4.9,702,84649,4.6,1557,38199,4.9,1349,-30960,15490,4.8,0,184,9878776
2024-10-21,AMD RX 7900 XTX,82280,5.0,252,64190,4.4,1758,47618,4.7,982,18090,34662,4.7,0,1,82280
2024-10-20,NVIDIA RTX 3060,47930,4.6,344,48354,3.9,1943,62104,4.2,1903,-424,-14174,4.233333333333333,1,14,671020
2024-10-20,NVIDIA RTX 3070,71772,4.1,1239,82383,4.1,1449,47277,4.0,472,-10611,24495,4.066666666666666,0,68,4880496
2024-10-20,NVIDIA RTX 3080,57699,3.7,1832,51766,4.4,905,70258,4.3,1518,5933,-12559,4.133333333333334,0,1,57699
2024-10-20,AMD RX 6600,55471,4.0,1553,29686,4.8,423,78850,4.1,701,25785,-23379,4.3,0,1,55471
2024-10-20,AMD RX 6700 XT,42617,3.7,760,63029,4.3,1465,27941,4.7,138,-20412,14676,4.233333333333333,0,128,5454976
2024-10-20,NVIDIA RTX 4060,33788,4.4,1455,36466,4.6,1947,24964,4.0,408,-2678,8824,4.333333333333333,0,55,1858340
2024-10-20,AMD RX 7900 XTX,65490,4.7,1226,54518,4.1,1660,57753,4.4,1672,10972,7737,4.4,0,1,65490
2024-10-19,NVIDIA RTX 3060,69531,4.7,750,40909,3.6,315,69171,4.2,1462,28622,360,4.166666666666667,0,1,69531
2024-10-19,NVIDIA RTX 3070,92665,4.9,1166,90782,4.1,437,52962,4.9,1929,1883,39703,4.633333333333334,0,33,3057945
2024-10-19,NVIDIA RTX 3080,35074,3.7,1212,56828,4.3,1046,43549,4.7,522,-21754,-8475,4.233333333333333,1,129,4524546
2024-10-19,AMD RX 6600,75629,4.0,1909,26100,4.5,1483,63920,3.7,1192,49529,11709,4.066666666666666,0,1,75629
2024-10-19,AMD RX 6700 XT,55398,4.0,838,85664,4.0,917,28214,4.3,241,-30266,27184,4.1000000000000005,0,169,9362262
2024-10-19,NVIDIA RTX 4060,62268,4.9,1366,50729,3.6,613,67503,4.9,1447,11539,-5235,4.466666666666667,0,1,62268
2024-10-19,AMD RX 7900 XTX,95423,5.0,1786,42839,4.9,769,51020,4.0,968,52584,44403,4.633333333333334,0,1,95423
2024-10-18,NVIDIA RTX 3060,24092,4.5,1012,86820,4.2,269,59438,4.9,544,-62728,-35346,4.533333333333333,1,347,8359924
2024-10-18,NVIDIA RTX 3070,58763,4.4,1372,59602,4.9,387,68798,3.7,1940,-839,-10035,4.333333333333333,1,55,3231965
2024-10-18,NVIDIA RTX 3080,54284,4.5,757,85993,4.8,449,80632,4.8,868,-31709,-26348,4.7,1,194,10531096
2024-10-18,AMD RX 6600,72915,4.1,1206,29339,3.7,702,28968,4.8,1849,43576,43947,4.2,0,1,72915
2024-10-18,AMD RX 6700 XT,59272,4.9,1783,42651,4.6,444,52455,3.6,998,16621,6817,4.366666666666666,0,1,59272
2024-10-18,NVIDIA RTX 4060,75359,4.7,1012,37669,4.6,1487,75948,3.8,879,37690,-589,4.366666666666667,0,1,75359
2024-10-18,AMD RX 7900 XTX,86165,3.9,1434,59072,4.2,464,39098,5.0,1137,27093,47067,4.366666666666666,0,1,86165
2024-10-17,NVIDIA RTX 3060,49856,4.3,296,56251,3.6,1482,90694,3.7,529,-6395,-40838,3.866666666666667,1,78,3888768
2024-10-17,NVIDIA RTX 3070,48347,4.3,1383,93539,4.2,197,41781,4.6,833,-45192,6566,4.366666666666666,0,258,12473526
2024-10-17,NVIDIA RTX 3080,32307,4.5,1684,95785,4.5,1451,66934,3.8,285,-63478,-34627,4.266666666666667,1,369,11921283
2024-10-17,AMD RX 6600,55555,4.1,312,38672,4.5,1009,91388,4.2,1141,16883,-35833,4.266666666666667,0,1,55555
2024-10-17,AMD RX 6700 XT,53350,4.7,1899,33770,3.5,1681,40422,3.5,878,19580,12928,3.9,0,1,53350
2024-10-17,NVIDIA RTX 4060,84343,4.7,247,73117,4.9,867,80331,4.9,304,11226,4012,4.833333333333334,0,1,84343
2024-10-17,AMD RX 7900 XTX,42346,4.2,779,54903,3.6,963,71440,4.9,1813,-12557,-29094,4.233333333333333,1,111,4700406
2024-10-16,NVIDIA RTX 3060,27681,3.6,464,25781,4.0,493,34115,4.9,1435,1900,-6434,4.166666666666667,0,33,913473
2024-10-16,NVIDIA RTX 3070,59589,3.6,1782,32086,4.9,297,63290,5.0,272,27503,-3701,4.5,0,1,59589
2024-10-16,NVIDIA RTX 3080,53955,4.1,1023,49935,3.8,951,76937,3.5,662,4020,-22982,3.7999999999999994,0,29,1564695
2024-10-16,AMD RX 6600,78558,4.0,897,90056,4.7,760,64742,3.7,609,-11498,13816,4.133333333333333,0,83,6520314
2024-10-16,AMD RX 6700 XT,41887,3.5,1575,51961,3.8,1209,49871,3.5,1162,-10074,-7984,3.6,1,74,3099638
2024-10-16,NVIDIA RTX 4060,35085,3.6,1837,77286,3.7,537,43563,4.5,1661,-42201,-8478,3.9333333333333336,1,222,7788870
2024-10-16,AMD RX 7900 XTX,34444,4.9,317,38799,4.0,130,27611,4.4,529,-4355,6833,4.433333333333334,0,62,2135528
2024-10-15,NVIDIA RTX 3060,65607,4.0,277,80066,4.0,897,63459,4.4,1786,-14459,2148,4.133333333333334,0,113,7413591
2024-10-15,NVIDIA RTX 3070,62484,4.1,1783,53645,3.8,1447,46075,3.8,1162,8839,16409,3.9,0,1,62484
2024-10-15,NVIDIA RTX 3080,29921,3.7,550,63821,4.4,189,47318,3.8,1900,-33900,-17397,3.9666666666666672,1,201,6014121
2024-10-15,AMD RX 6600,43078,4.7,1839,32615,4.1,1671,37668,3.5,517,10463,5410,4.1000000000000005,0,1,43078
2024-10-15,AMD RX 6700 XT,65857,3.7,1487,88314,4.6,1720,65422,4.4,1961,-22457,435,4.233333333333333,0,141,9285837
2024-10-15,NVIDIA RTX 4060,70997,4.3,1236,46536,4.9,1328,61851,4.0,1704,24461,9146,4.3999999999999995,0,1,70997
2024-10-15,AMD RX 7900 XTX,41539,3.6,1272,69681,4.5,1488,28101,3.5,1063,-28142,13438,3.8666666666666667,0,175,7269325
2024-10-14,NVIDIA RTX 3060,78053,4.3,274,42143,3.8,1659,27667,4.9,195,35910,50386,4.333333333333333,0,1,78053
2024-10-14,NVIDIA RTX 3070,63656,4.6,1950,69134,4.2,786,76320,4.6,447,-5478,-12664,4.466666666666667,1,77,4901512
2024-10-14,NVIDIA RTX 3080,68803,4.1,1422,29298,4.9,1019,43551,3.5,1937,39505,25252,4.166666666666667,0,1,68803
2024-10-14,AMD RX 6600,90347,3.7,552,76304,4.5,576,51943,4.1,235,14043,38404,4.1,0,1,90347
2024-10-14,AMD RX 6700 XT,56718,3.7,1474,92796,4.6,127,40629,4.2,950,-36078,16089,4.166666666666667,0,196,11116728
2024-10-14,NVIDIA RTX 4060,33624,4.2,1225,52661,4.4,1936,80827,4.8,1757,-19037,-47203,4.466666666666668,1,115,3866760
2024-10-14,AMD RX 7900 XTX,33968,4.5,613,40790,3.9,977,24645,4.2,1942,-6822,9323,4.2,0,81,2751408
2024-10-13,NVIDIA RTX 3060,36488,4.6,1097,58999,3.6,381,56717,4.0,1205,-22511,-20229,4.066666666666666,1,139,5071832
2024-10-13,NVIDIA RTX 3070,68290,3.7,1442,75174,3.9,410,74943,4.5,297,-6884,-6653,4.033333333333333,1,58,3960820
2024-10-13,NVIDIA RTX 3080,53559,3.9,242,72924,4.5,587,88661,4.6,1844,-19365,-35102,4.333333333333333,1,122,6534198
2024-10-13,AMD RX 6600,49965,4.2,772,82852,3.7,750,48757,3.8,365,-32887,1208,3.9,0,205,10242825
2024-10-13,AMD RX 6700 XT,67745,4.4,1258,31457,4.7,949,42537,4.5,1622,36288,25208,4.533333333333334,0,1,67745
2024-10-13,NVIDIA RTX 4060,72365,4.9,445,60002,3.8,1600,40299,4.1,1916,12363,32066,4.266666666666667,0,1,72365
2024-10-13,AMD RX 7900 XTX,25198,3.9,553,68227,3.9,1204,37838,3.8,478,-43029,-12640,3.8666666666666667,1,260,6551480
2024-10-12,NVIDIA RTX 3060,81429,4.8,375,34534,5.0,1741,64158,4.6,1046,46895,17271,4.8,0,1,81429
2024-10-12,NVIDIA RTX 3070,69389,4.2,834,56137,4.8,1167,94380,4.4,1909,13252,-24991,4.466666666666667,0,1,69389
2024-10-12,NVIDIA RTX 3080,66027,4.3,459,65660,4.2,112,58038,4.0,867,367,7989,4.166666666666667,0,36,2376972
2024-10-12,AMD RX 6600,35042,4.8,386,34496,3.6,494,45780,4.6,1842,546,-10738,4.333333333333333,0,35,1226470
2024-10-12,AMD RX 6700 XT,49902,4.6,1383,34025,5.0,518,29639,4.4,1726,15877,20263,4.666666666666667,0,1,49902
2024-10-12,NVIDIA RTX 4060,37981,3.6,138,39208,3.8,1224,49430,3.5,1399,-1227,-11449,3.6333333333333333,1,52,1975012
2024-10-12,AMD RX 7900 XTX,93650,3.5,1291,50722,4.3,972,28419,3.7,760,42928,65231,3.8333333333333335,0,1,93650
2024-10-11,NVIDIA RTX 3060,79934,3.8,175,85771,3.7,504,28221,4.2,1856,-5837,51713,3.9,0,58,4636172
2024-10-11,NVIDIA RTX 3070,60611,4.8,1205,57575,3.8,609,68613,4.4,1773,3036,-8002,4.333333333333333,0,3,181833
2024-10-11,NVIDIA RTX 3080,89235,4.7,849,64065,4.4,1401,78873,5.0,1028,25170,10362,4.7,0,1,89235
2024-10-11,AMD RX 6600,75274,4.8,1307,50625,4.8,1085,60917,4.2,1625,24649,14357,4.6000000000000005,0,1,75274
2024-10-11,AMD RX 6700 XT,61237,4.2,1145,35432,4.1,443,63978,4.7,1992,25805,-2741,4.333333333333333,0,1,61237
2024-10-11,NVIDIA RTX 4060,37119,4.0,121,87312,4.1,1348,68979,5.0,481,-50193,-31860,4.366666666666666,1,292,10838748
2024-10-11,AMD RX 7900 XTX,58340,4.5,1650,80086,4.7,1725,58253,4.7,1098,-21746,87,4.633333333333333,0,125,7292500
2024-10-10,NVIDIA RTX 3060,90537,4.2,466,85338,4.6,975,87243,3.6,1853,5199,3294,4.133333333333334,0,5,452685
2024-10-10,NVIDIA RTX 3070,47158,4.2,834,35368,4.4,412,71127,3.9,1701,11790,-23969,4.166666666666667,0,1,47158
2024-10-10,NVIDIA RTX 3080,29089,4.6,574,47136,4.1,726,73390,4.5,1212,-18047,-44301,4.3999999999999995,1,129,3752481
2024-10-10,AMD RX 6600,32404,4.1,187,83774,4.1,1341,39318,3.8,1036,-51370,-6914,4.0,1,293,9494372
2024-10-10,AMD RX 6700 XT,53344,4.9,839,85614,4.0,1564,37551,4.3,705,-32270,15793,4.3999999999999995,0,201,10722144
2024-10-10,NVIDIA RTX 4060,76715,4.9,1905,85109,3.7,488,41401,4.0,993,-8394,35314,4.2,0,64,4909760
2024-10-10,AMD RX 7900 XTX,28412,5.0,763,22652,4.8,1595,37008,3.8,1779,5760,-8596,4.533333333333334,0,10,284120
2024-10-09,NVIDIA RTX 3060,41294,5.0,1397,75079,4.1,951,90561,3.7,1493,-33785,-49267,4.266666666666667,1,212,8754328
2024-10-09,NVIDIA RTX 3070,60004,4.4,1267,76783,4.1,730,51215,3.8,1624,-16779,8789,4.1000000000000005,0,97,5820388
2024-10-09,NVIDIA RTX 3080,47871,4.5,848,34684,4.8,1987,72696,4.4,410,13187,-24825,4.566666666666667,0,1,47871
2024-10-09,AMD RX 6600,36434,3.9,1958,41467,4.9,432,95842,3.6,1191,-5033,-59408,4.133333333333334,1,59,2149606
2024-10-09,AMD RX 6700 XT,55445,4.1,1773,51031,4.9,1679,73953,3.8,1187,4414,-18508,4.266666666666667,0,1,55445
2024-10-09,NVIDIA RTX 4060,71212,4.7,1916,71862,4.6,1400,46923,3.7,1493,-650,24289,4.333333333333333,0,35,2492420
2024-10-09,AMD RX 7900 XTX,26975,4.8,1000,75963,3.6,889,48911,4.5,1366,-48988,-21936,4.3,1,273,7364175
2024-10-08,NVIDIA RTX 3060,45590,3.6,1417,79600,3.9,170,57522,3.7,1348,-34010,-11932,3.733333333333333,1,211,9619490
2024-10-08,NVIDIA RTX 3070,60538,3.7,422,74539,4.6,157,79232,3.9,920,-14001,-18694,4.066666666666667,1,111,6719718
2024-10-08,NVIDIA RTX 3080,74408,4.6,342,43523,4.4,1494,64055,4.9,962,30885,10353,4.633333333333334,0,1,74408
2024-10-08,AMD RX 6600,55587,4.7,1575,43398,3.9,1284,88294,4.0,1577,12189,-32707,4.2,0,1,55587
2024-10-08,AMD RX 6700 XT,40799,4.5,1081,43259,3.7,289,61322,3.6,1550,-2460,-20523,3.933333333333333,1,37,1509563
2024-10-08,NVIDIA RTX 4060,54456,3.7,1806,75634,4.6,1945,64552,4.9,1355,-21178,-10096,4.4,1,141,7678296
2024-10-08,AMD RX 7900 XTX,76040,3.9,361,36778,4.9,1894,31242,4.6,387,39262,44798,4.466666666666667,0,1,76040
2024-10-07,NVIDIA RTX 3060,44222,4.4,180,78794,4.7,617,44786,4.7,1665,-34572,-564,4.6000000000000005,1,200,8844400
2024-10-07,NVIDIA RTX 3070,41707,3.7,1989,65713,5.0,1448,56985,4.7,1423,-24006,-15278,4.466666666666666,1,148,6172636
2024-10-07,NVIDIA RTX 3080,49829,4.9,1327,76973,4.0,942,80123,4.4,609,-27144,-30294,4.433333333333334,1,164,8171956
2024-10-07,AMD RX 6600,30334,4.6,1782,34543,4.5,1690,68505,3.8,665,-4209,-38171,4.3,1,72,2184048
2024-10-07,AMD RX 6700 XT,59854,3.8,1342,68309,3.9,529,43695,3.7,1614,-8455,16159,3.7999999999999994,0,63,3770802
2024-10-07,NVIDIA RTX 4060,87734,3.8,1800,79888,4.0,444,43588,4.2,1476,7846,44146,4.0,0,1,87734
2024-10-07,AMD RX 7900 XTX,80762,3.7,1293,86463,3.6,1684,60788,3.5,340,-5701,19974,3.6,0,49,3957338
